Nome Articolo	Fornitore Greggio	IDCOLL
ABBOT ACC. LIGHT	Taborelli	CV
ABBOT ACC. REPS	Taborelli	CV
ABBOT IN SEMPLICE	Taborelli	CV
ABRAM ACTIVE	Corti	CV
ABRAM DAVISON	Corti	CV
ABRAM KYKO	Beccalli	CV
ABRAM PLAYGROUND	Corti	CV
ABRIL	Taborelli	CV
ACKLEY ACC. TELA	Tat	CV
ACKLEY ACC.LIGHT	Tat	CV
ACKLEY IN SEMPLICE	Tat	CV
ACTIVE  ACC. TELA  NO IDRO	Corti	CSP
ACTIVE ACC DENIM	Corti	CE09
ACTIVE ACC. DENIM RESINATO	Corti	CSP
ACTIVE ACC. PANAMA CITY NERO	Corti	CSP
ACTIVE ACC. TELA + IDRO	Corti	
ACTIVE ACC.TELA FERMO FILO NERO GIARDINI	Corti	CSP
ACTIVE FIN. CARBONE TELA	Corti	CSP
ACTIVE FIN.CARBONE  SEMPLICE	Corti	CSP
ACTIVE LIGHT	Corti	CCL
ACTIVE LIGHT + IDRO	Corti	CSP
ACTIVE PRONTO TINTA	Corti	CSP
ACTIVE REPS IDRO	Corti	CCL
ACTIVE RESINATO + DIRITTO FILO + IDRO	Corti	CSP
ACTIVE RESINATO EXPERT	Corti	CCL
ACTIVE RESINATO PROVA 1	Corti	CSP
ACTIVE RESINATO PROVA 2	Corti	CSP
ACTIVE SCHIUMATO	Corti	CSP
ACTIVE SCUBA	Corti	CCL
ACTIVE SEMPLICE	Corti	CCL
ACTIVE SOFT	Corti	CCL
ACTIVE TELA  BEROFIN	Corti	CCL
ACTIVE TELA + OLUVELI	Corti	
ACTIVE TELA EXPERT + WR PIENO BAGNO BEROFIN -BALLY	Corti	
ACTIVE TELA EXPERT+ WR A CASCATA BEROFIN  BALLY	Corti	
ADAM ACC. LIGHT	My Way	CV
ADAM ACC. REPS	My Way	CV
ADAM ACC. TELA	My Way	CV
ADAM ACC. TELA PRONTO TINTA	My Way	CV
ADAM IN SEMPLICE	My Way	CV
ADAM METAL LIGHT	My Way	CV
ADJAN	Lange	CV
ADONIS ACC. STRETCH VAR.01 ARGENTO	Piave	CV
ADONIS ACC. STRETCH VAR.02 ORO	Piave	CV
AFRICAN REPS	Santi	CV
AFRICAN SEMPLICE	Santi	CV
AFRICAN SOFT	Santi	CV
AFROMAN	Ambiente Uomo	CV
AFROMAN V.2/3	Ambiente Uomo	CV
AGLAS	Toia	CV
AIR BALL DENIM	Tat	CV
AIR BALL REPS	Tat	CV
AIR BALL STRETCH	Tat	CV
AIR BLUE SEMPLICE	Clementi	CV
AIR BLUE SOFT	Clementi	CV
AIR BLUE SPALMATO	Clementi	CV
AIR BLUE TELA	Clementi	CV
AIR KAT IN SEMPLICE	Tex Fation	CV
AIR KAT SOFT	Tex Fation	CV
AIR KAT SPALMATO	Tex Fation	CV
AIR KAT TELA	Tex Fation	CV
AIR TANK ACC LIGHT	Taborelli	CI09/10
AIR TANK IN SEMPLICE	Taborelli	CI09/10
AIR TANK REPS	Taborelli	CI09/10
AIR TANK RESINATO EXPERT	Taborelli	
AIR TEX	Corti	CV
AISHA  VAR.2 ORO	Piave	CV
AISHA VAR.1 ARGENTO	Piave	CV
AJAY IN SEMPLICE	Mariani cinese	CV
AJAY REPS	Mariani cinese	CV
AJAY SOFT	Mariani cinese	CV
AJAY STRETCH	Mariani cinese	CV
AKA	Corti	CV
AKASH ACC. LIGHT	Lange	CV
AKASH ACC. TELA	Lange	CV
AKASH IN SEMPLICE	Lange	CV
AKASH RESINATO	Lange	CV
AKEEM	Heat Coat	CV
AKIL ACC. LIGHT	Ambiente Uomo	CV
AKIL ACC.REPS	Ambiente Uomo	CV
AKIL IN SEMPLICE	Ambiente Uomo	CV
AKIR LIGHT	Corti	CV
AKIR RESINATO	Corti	CV
AKIR SEMPLICE	Corti	CV
AKIR TELA	Corti	CV
AKLYS	Lange	CV
AKYA	Riedel Textil	CV
ALEX  IN SEMPLICE	Uco	CV
ALEX ACC. TELA	Uco	CV
ALEXYS	Taborelli	CV
ALLEN  COLORATO	Corti	CV
ALLEN COL.NERO	Corti	CV
ALLEN SEMPLICE	Griffine	CV
ALLEN STRETCH	Griffine	CV
ALLEN TELA	Griffine	CV
ALLISON LIGHT	Corti	CV
ALLISON RESINATO	Corti	CV
ALLISON SEMPLICE	Corti	CV
ALLISON SOFT	Corti	CV
ALLISON TELA	Corti	CV
ALLJEANS	Transatex	CV
ALMA	Mariani cinese	CV
ALMA  ACC. REPS	Frigerio	CV
ALMA ACC. LIGHT	Frigerio	CV
ALMA IN SEMPLICE	Frigerio	CV
ALONZO	Lange	CV
AMAYA DENIM	Ripa	CV
AMAYA IN SEMPLICE	Ripa	CV
AMAYA SCUBA	Ripa	CV
AMAYA STERTCH	Ripa	CV
AMBER REPS	My Way	CV
AMBER RESINATO	My Way	CV
AMBER SEMPLICE	My Way	CV
AMBER SOFT	My Way	CV
AMISH  ACC. TELA	Lange	CV
AMISH ACC. LIGHT	Lange	CV
AMISH IN SEMPLICE	Lange	CV
AMISH RESINATO	Lange	CV
AMOS	Ambiente Uomo	CV
AMOUR BIANCO	Miti	CV
AMOUR COLORATO	Miti	CV
AMOUR NERO	Miti	CV
ANANSI	Corti	CV
ANARKY	Tex Fation	CV
ANDRES BIANCO	Miti	CV
ANDRES COLORATI	Miti	CV
ANDRES NERO	Miti	CV
ANIMALIER	Furpile Maglia	CI 11/12
ANTIGUA IN SEMPLICE	Lange	CCL
ANTIGUA LIGHT	Lange	CCL
ANTIGUA TELA	Lange	CCL
ANTIK	Dalmatex	CV
ANTIK STRETCH	Dalmatex	CV
ANUK REPS	Redaelli	CV
ANUK SEMPLICE	Redaelli	CV
ANUK SOFT	Redaelli	CV
APASIO	Sat idea	CV
APASIO ACC. LIGHT	Taborelli	CV
APASIO ACC. REPS	Taborelli	CV
APASIO IN SEMPLICE	Taborelli	CV
AQUAGOM	Clerprem	CV
AQUASMOKE	Clerprem	CV
AR 64 SEMPLICE PE 12	Ricamificio 2G	CE 12
ARCHY RESINATO	My Way	CV
ARCHY SEMPLICE	My Way	CV
ARCHY SOFT	My Way	CV
ARCHY TELA	My Way	CV
ARROW	Namsan Technology	CV
ART 15 BIANDOLINO	Taborelli	CSP
ART PA/ COT ACC DENIM + IDRO	Raion Inveruno	CSP
ART. STAR SERATA NERO PER GUCCI LIGHT +IDRO	Taborelli	CSP
ART. STAR SERATA NERO PER GUCCI RESINA +IDRO	Taborelli	CSP
ART.16+16/BIS+16/3	Taborelli	CSP
ARTICOLO 1 IN SEMPLICE	Manifattura Baroli	CSP
ARTICOLO 2 IN SEMPLICE	Manifattura Baroli	CSP
ARTICOLO 3 IN SEMPLICE	Manifattura Baroli	CSP
ARTICOLO 4 IN SEMPLICE	Manifattura Baroli	CSP
ARTICOLO LANGE X STAMPERIA LUCE	Lange	CSP
ARTLAB REPS	Star	CV
ARTLAB RESINATO	Star	CV
ARTLAB SEMPLICE	Star	CV
ARTLAB SOFT	Star	CV
ARUBA ACC. LIGHT	My Way	CV
ARUBA ACC. TELA	My Way	CV
ARUBA IN SEMPLICE	My Way	CV
ASHAN REPS	Redaelli	CV
ASHAN RESINATO	Redaelli	CV
ASHAN SEMPLICE	Redaelli	CV
ASHAN SOFT	Redaelli	CV
ASHANTI ACC. LIGHT	Ambiente Uomo	CV
ASHANTI ACC. REPS	Ambiente Uomo	CV
ASHANTI IN SEMPLICE	Ambiente Uomo	CV
ASHE	Mariani cinese	CV
ASHLIN ACC. LIGHT	Namsan Technology	CV
ASHLIN ACC. REPS	Namsan Technology	CV
ASHLIN ACC. TELA	Namsan Technology	CV
ASHLIN IN SEMPLICE	Namsan Technology	CV
ASHMIR ACC REPS + IDRO EUROFINISS	Redaelli	CSP
ASHMIR ACC. LIGHT	Redaelli	CCL
ASHMIR ACC. REPS STAMPA FERRADINI	Redaelli	CSP
ASHMIR REPS	Redaelli	CCL
ASHMIR REPS COLORE AL CAMP.CLIENTE	Redaelli	CSP
ASHMIR RESINATO	Redaelli	CCL
ASHMIR SEMPLICE	Redaelli	CCL
ASHMIR SOFT	Redaelli	CCL
ASHMIR SOFT COLORE AL CAMP.CLIENTE	Redaelli	CSP
ASPEN ACC LIGHT	Taborelli	CI09/10
ASPEN ACC REPS	Taborelli	CI09/10
ASPEN ACC TELA	Taborelli	CI09/10
ASPEN IN SEMPLICE	Taborelli	CI09/10
ASPHALT SEMPLICE	Griffine	CV
ASPHALT STRETCH	Griffine	CV
ASPHALT TELA	Griffine	CV
ASTRAKAN REPS	Molteni	CV
ASTRAKAN SEMPLICE	Molteni	CV
ASTRAKAN SOFT	Molteni	CV
ASTRAKAN SPALMATO	Molteni	CV
ASTRALAND ACC. LIGHT	Taborelli	CV
ASTRALAND ACC. TELA	Taborelli	CV
ASTRALAND IN SEMPLICE	Taborelli	CV
ASTRAWORLD	Taborelli	CV
ATHLETIC DENIM	Borgini	CV
ATHLETIC SEMPLICE	Borgini	CV
ATHLETIC SOFT	Borgini	CV
ATHLETIC SPALMATO	Borgini	CV
ATHLETIC TELA	Borgini	CV
ATOM	Tat	CSP
ATTY	Perlini	CV
AVIATOR + GARDEN	Miti	CV
AVIATOR ACC. REPS	Miti	CV
AVIATOR IN SEMPLICE	Miti	CV
AVIATOR LIGHT	Miti	CV
AVIATOR MONTY	Miti	CV
AVIATOR TELA	Miti	CV
AWAYAN LIGHT	Beccalli	CV
AWAYAN REPS	Beccalli	CV
AWAYAN RESINATO	Beccalli	CV
AWAYAN SEMPLICE	Beccalli	CV
AYAKO REPS	Mariani cinese	CV
AYAKO SEMPLICE	Mariani cinese	CV
AYAKO SOFT	Mariani cinese	CV
AYAKO SPALMATO	Mariani cinese	CV
AYAKO TELA	Mariani cinese	CV
AYASHI LOFT	Griffine	CV
AYASHI SEMPLICE	Griffine	CV
AYOMI	Ambiente Uomo	CV
BABY JAM ACC. LIGHT	Taborelli	CV
BABY JAM ACC. REPS	Taborelli	CV
BABY JAM IN SEMPLICE	Taborelli	CV
BABY SATIN ACC. TELA	Beccalli	CCL
BABY SATIN ACC.LIGHT	Beccalli	CCL
BABY SATIN IN SEMPLICE	Beccalli	CCL
BAILEY	My Way	CV
BAILEY ACC LIGHT	Taborelli	CI09/10
BAILEY ACC REPS	Taborelli	CI09/10
BAILEY IN SEMPLICE	Taborelli	CI09/10
BAJA REPS	Ambiente Uomo	CV
BAJA RESINATO	Ambiente Uomo	CV
BAJA SEMPLICE	Ambiente Uomo	CV
BAJA SOFT	Ambiente Uomo	CV
BAJADER	Tessil Due	CV
BAKER SEMPLICE	Tat	CV
BAKER STRETCH	Tat	CV
BALI ACC. LIGHT	Taborelli	CV
BALI ACC. REPS	Taborelli	CV
BALI ACC. TELA	Taborelli	CV
BALI IN SEMPLICE	Taborelli	CV
BALLARD	Corti	CV
BALLER	Cifra	CV
BALLY BOTTONATO LOFT	Frigerio	CV
BALLY BOTTONATO RESINATO	Frigerio	CV
BALLY BOTTONATO SOFT	Frigerio	CV
BALLY COT. 20000 LOFT	Frigerio	CV
BALLY COT. 20000 RESINATO	Frigerio	CV
BALLY COT. 20000 SOFT	Frigerio	CV
BALLY VISCOSA LANA LOFT	Frigerio	CV
BALLY VISCOSA LANA RESINATO	Frigerio	CV
BALLY VISCOSA LANA SOFT	Frigerio	CV
BALLY WO CARDATO 15000 LOFT	Frigerio	CV
BALLY WO CARDATO 15000 RESINATO	Frigerio	CV
BALLY WO CARDATO 15000 SOFT	Frigerio	CV
BALTIMORE ACC.LIGHT	Corti	CCL
BALTIMORE ACC.REPS	Corti	CCL
BALTIMORE IN SEMPLICE	Corti	CCL
BALTIMORE OVATTA 80 GR + LIGHT	Corti	SP
BAMBOO ACC. LIGHT	Lange	CV
BAMBOO ACC. TELA	Lange	CV
BAMBOO ACC.REPS	Lange	CV
BAMBOO IN SEMPLICE	Lange	CV
BANDANAS  SEMPLICE	Lange	CV
BANDANAS RESINATO	Lange	CV
BANDANAS SOFT	Lange	CV
BANDANAS TELA	Lange	CV
BANJO ACC. LIGHT	Taborelli	CV
BANJO ACC. TELA	Taborelli	CV
BANJO IN SEMPLICE	Taborelli	CV
BARBADOS ACC LIGHT	Lange	CCL
BARBADOS ACC TELA	Lange	CCL
BARBADOS IN SEMPLICE	Lange	CV
BARFLY	Forma	CV
BARKLEY ACC DENIM	Corti	CSP
BARKLEY ACC LIGHT	Corti	CCL
BARKLEY ACC REPS	Corti	CSP
BARKLEY ACC TELA	Corti	CCL
BARKLEY IN SEMPLICE	Corti	CCL
BARKLEY PRONTO TINTA	Corti	CSP
BARRY WHITE  ACC. REPS BEROFIN	My Way	CV
BARRY WHITE ACC. LIGHT BEROFIN	My Way	CV
BARRY WHITE IN SEMPLICE	My Way	CV
BASE NEW KUMQUAT SEMPLICE	Tat	CV
BASE WHITE FLOWERS ACC TELA	Taborelli	CSP
BASE WHITE FLOWERS IN SEMPLICE	Taborelli	CSP
BASKET	Donghi	CV
BASKET METAL IN SEMPLICE ARGENTO	Romano'	CCL
BASKET METAL IN SEMPLICE colorato	Romano'	CCL
BASKET METAL IN SEMPLICE ORO SATINATO	Romano'	CCL
BASKET METAL LIGHT colorato	Romano'	CCL
BASKET METAL LIGHT ORO SATINATO	Romano'	CCL
BASKET METAL LIGHT ORO/ ARGENTO	Romano'	CCL
BASKET METAL TELA ARGENTO	Romano'	CCL
BASKET METAL TELA colorato	Romano'	CCL
BASKET METAL TELA ORO SATINATO	Romano'	CCL
BAY	Toia	CV
BAYA AZUL ACC. LIGHT	Lange	CCL
BAYA AZUL ACC. TELA	Lange	CCL
BAYA AZUL IN SEMPLICE	Lange	CCL
BAYLIN BIANCO	Erco Pizzi	CV
BAYLIN NERO	Erco Pizzi	CV
BEACH BIANCO GUCCI + IDRO+FORO	Eurojersey	CSP
BEACH BIANCO GUCCI FORATO no idro	Eurojersey	CSP
BEACH COLORATO FORATO gucci	Eurojersey	CSP
BEACH COLORATO GUCCI	Eurojersey	CSP
BEACH COLORE AL CAMPIONE  FORATO gucci	Eurojersey	CSP
BEACH COSTO ACCOPPIATURA	Map	CSP
BEACH SOLO COSTO ACCOPPIATURA + FORO	Il Foro	CSP
BEAVER	Ermapel	CV
beker resinato	Tat	CV
BELFAST RESINATO EXPERT	My Way	
BENJY	Piave	CV
BENJY COLORATI	Piave	CV
BENNY	Toia	CV
BERGHEN RESINATO EXPERT	My Way	
BERRY ACC. TELA	Corti	CV
BERRY IN SEMPLICE	Corti	CV
BERRY LIGHT	Corti	CV
BERRY REPS	Gif	CV
BERRY RESINATO	Gif	CV
BERRY SEMPLICE	Gif	CV
BERRY SOFT	Gif	CV
BI ZONE	Sitip	CV
BIG  TWILLE ACC. REPS + IDRO	Taborelli	CV
BIG CANVAS ACC TELA COLORATO	Lange	CCL
BIG CANVAS ACC. TELA COL. NATURALE	Lange	
BIG LEO ACC. LIGHT	Beccalli	CV
BIG LEO ACC. REPS	Beccalli	CV
BIG LEO ACC. TELA	Beccalli	CV
BIG LEO IN SEMPLICE	Beccalli	CV
BIG RUNNER ACC LIGHT	Corti	CE 12
BIG RUNNER ACC REPS	Corti	CE 12
BIG RUNNER SEMPLICE	Corti	CE 12
BIG SAND ACC LIGHT	Lange	CCL
BIG SAND ACC TELA	Lange	CCL
BIG SAND IN SEMPLICE	Lange	CCL
BIG SAND RESINATO BEROFIN	Lange	CCL
BIG SAND RESINATO EXPERT	Lange	CCL
BIG SKY    ORO/ARGENTO	Taborelli	CV
BIG STONE  ACC.TELA	Corti	CCL
BIG STONE ACC. DENIM NERO	Corti	CSP
BIG STONE ACC.LIGHT	Corti	CCL
BIG STONE IN SEMPLICE	Corti	CCL
BIG TWILL ACC. LIGHT	Taborelli	CV
BIG TWILLE ACC. TELA BEROFIN	Taborelli	CV
BIG. STONE ACC. TELA + IDRO BEROFIN	Corti	CSP
BIG. TWILL IN SEMPLICE	Taborelli	CV
BIG. TWILLE ACC. SOFT + IDRO	Taborelli	CV
BIG.TWILLE	Taborelli	CV
BIKINIS	Lange	CV
BILLA	Heat Coat	CV
BIZZY SEMPLICE	Tat	CV
BIZZY STRETCH	Tat	CV
BLACK  JUNGLE	Frigerio	CV
BLACK AFRICA ACC. LIGHT	Frigerio	CV
BLACK AFRICA ACC. TELA	Frigerio	CV
BLACK AFRICA IN SEMPLICE	Frigerio	CV
BLACK BARRY ACC.LIGHT	Taborelli	CCL
BLACK BARRY ACC.REPS	Taborelli	CCL
BLACK BARRY IN SEMPLICE	Taborelli	CCL
BLACK CHOCO ACC LIGHT	Taborelli	CE 10
BLACK CHOCO ACC REPS	Taborelli	CE 10
BLACK CHOCO IN SEMPLICE	Taborelli	CE 10
BLACK CROCO ACC.LIGHT	Dalmatex	CCL
BLACK CROCO IN SEMPLICE	Dalmatex	CCL
BLACK DIAMOND LAMINA COLOR.  ACC. REPS	Erco Pizzi	CV
BLACK DIAMOND LAMINA COLOR.ACC.LIGHT	Erco Pizzi	CV
BLACK DIAMOND LAMINA ORO/ARG. ACC. LIGHT	Erco Pizzi	CV
BLACK DIAMOND LAMINA ORO/ARG. ACC. REPS	Erco Pizzi	CV
BLACK GLITT	My Way	CV
BLACK GLITT LAMINA COLORATA	My Way	CV
BLACK GLITT LAMINA ORO/AGENTO	My Way	CV
BLACK HOT	Frigerio	CV
BLACK IRON acc LIGHT	Taborelli	CE 10
BLACK IRON acc TELA	Taborelli	CE 10
BLACK IRON IN SEMPLICE	Taborelli	CE 10
BLACK JAM ACC. LIGHT	Corti	CV
BLACK JAM ACC. TELA	Corti	CV
BLACK JAM IN SEMPLICE	Corti	CV
BLACK LADY ACC LIGHT	Taborelli	CE 10
BLACK LADY ACC TELA	Taborelli	CE 10
BLACK LADY IN SEMPLICE	Taborelli	CE 10
BLACK LAME'	Frigerio	CV
BLACK LEGEND ACC LIGHT	Pozzi	CE 10
BLACK LEGEND ACC TELA	Pozzi	CE 10
BLACK LEGEND IN SEMPLICE	Pozzi	CE 10
BLACK LEO LIGHT	Miti	CV
BLACK LEO SEMPLICE	Miti	CV
BLACK LEO TELA	Miti	CV
BLACK MESH + IDRO SEMPLICE	Corti	CSP
BLACK MESH ART 64 ACC LIGHT	Corti	CI 10/11
BLACK MESH ART 64 ACC TELA	Corti	CI 10/11
BLACK MESH ART 64 IN SEMPLICE	Corti	CI 10/11
BLACK NEOPREN	Carvico	CI 11/12
BLACK PYTON LIGHT	Dalmatex	CI09/10
BLACK PYTON TELA	Dalmatex	CI09/10
BLACK RIO ACC LIGHT	Lange	CE 10
BLACK RIO ACC TELA	Lange	CE 10
BLACK RIO IN SEMPLICE	Lange	CE 10
BLACK SAND ACC.LIGHT	Taborelli	CV
BLACK SAND ACC.TELA	Taborelli	CV
BLACK SAND COBRA ACC LIGHT	Taborelli	CE 10
BLACK SAND COBRA ACC TELA	Taborelli	CE 10
BLACK SAND COBRA IN SEMPLICE	Taborelli	
BLACK SAND IN SEMPLICE	Taborelli	CV
BLACK SHARK ACC LIGHT	Corti	CI09/10
BLACK SHARK ACC REPS	Corti	CI09/10
BLACK SHARK CON OVATTA 120	Corti	CSP
BLACK SHARK IN SEMPLICE	Corti	CI09/10
BLACK SOUL ACC. LIGHT	Sat idea	CV
BLACK SOUL ACC. REPS	Sat idea	CV
BLACK SOUL IN SEMPLICE	Sat idea	CV
BLACK VELVET	Namsan Technology	CV
BLACK VELVET ACC.REPS NO IDRO BEROFIN	My Way	CV
BLACK VENIX ACC.LIGHT	Dalmatex	CV
BLACK VENIX IN SEMPLICE	Dalmatex	CV
BLACK WOOL  ACC LIGHT	Taborelli	CI 10/11
BLACK WOOL ACC REPS	Taborelli	CI 10/11
BLACK WOOL ART 83 IN SEMPLICE	Taborelli	CI 10/11
BLACK WOOL CRINKLE ACC LIGHT	Taborelli	CI 10/11
BLACK WOOL CRINKLE IN SEMPLICE	Taborelli	CI 10/11
BLACKBULL ACC. MTP 2 MM	Maglificio Tgv	CV
BLADE	Lange	CV
BLOOM	Tex Fation	CV
BLU SKY PESANTE	Dalmatex	CV
BLUE  VELVET	My Way	CV
BLUE ANGEL	Toia	CV
BLUE ANGEL ACC. LIGHT	Taborelli	CV
BLUE ANGEL ACC. TELA	Taborelli	CV
BLUE ANGEL IN SEMPLICE	Taborelli	CV
BLUE BABY	Croma srl	CV
BLUE BAHIA ACC LIGHT	Frigerio	CE 11
BLUE BAHIA ACC REPS	Frigerio	CE 11
BLUE BAHIA CRINKLE	Frigerio	CE 11
BLUE BAHIA CRINKLE LIGHT	Frigerio	CE 11
BLUE BAHIA IN SEMPLICE	Frigerio	CE 11
BLUE BAHIA RESINATO	Frigerio	CSP
BLUE BARRY ACC. LIGHT	Taborelli	CV
BLUE BARRY ACC. REPS	Taborelli	CV
BLUE BARRY IN SEMPLICE	Taborelli	CV
BLUE BAY ACC. LIGHT	Lange	CV
BLUE BAY ACC. TELA	Lange	CV
BLUE BAY IN SEMPLICE	Lange	CV
BLUE BEACH ACC LIGHT	Beccalli	CCL
BLUE BEACH ACC REPS	Beccalli	CCL
BLUE BEACH IN SEMPLICE	Beccalli	CCL
BLUE BELL	Beccalli	CV
BLUE CALYPSO	Radici Group	CI09/10
BLUE CHRONO ACC LIGHT	Pozzi	CE 10
BLUE CHRONO ACC TELA	Pozzi	CE 10
BLUE CHRONO IN SEMPLICE	Pozzi	CE 10
BLUE CRINKLE ACC. LIGHT	Corti	CV
BLUE CRINKLE ACC. REPS	Corti	CV
BLUE CRINKLE ACC. TELA	Corti	CV
BLUE CRINKLE IN SEMPLICE	Corti	CV
BLUE DENIM ACC. LIGHT WASHED	Berto spa	CV
BLUE DENIM ACC. TELA	Berto spa	CV
BLUE DENIM ACC. TELA WASHED	Berto spa	CV
BLUE DENIM IN SEMPLICE	Berto spa	CV
BLUE DENIM IN SEMPLICE WASHED	Berto spa	CV
BLUE DENIMACC. LIGHT	Berto spa	CV
BLUE DIAMOND LAMINA COLORATA	Erco Pizzi	CV
BLUE DIAMOND LAMINA ORO/ARGENTO	Erco Pizzi	CV
BLUE FALLS ACC LIGHT	Taborelli	CI09/10
BLUE FALLS ACC REPS	Taborelli	CI09/10
BLUE FALLS IN SEMPLICE	Taborelli	CI09/10
BLUE FIRE	Erco Pizzi	CV
BLUE FLOWER LIGHT	Lange	CV
BLUE FLOWER SEMPLICE	Lange	CV
BLUE FLOWER TELA	Lange	CV
BLUE ISLAND ACC. LIGHT	Taborelli	CV
BLUE ISLAND ACC. REPS	Taborelli	CV
BLUE ISLAND IN SEMPLICE	Taborelli	CV
BLUE JANEIRO VAR 1 A 6 ACC LIGHT	Pozzi	CE 10
BLUE JANEIRO VAR 1 A 6 ACC TELA	Pozzi	CE 10
BLUE JANEIRO VAR 1 A 6 IN SEMPLICE	Pozzi	CE 10
BLUE JANEIRO VAR 7 A 12 ACC LIGHT	Pozzi	CE 10
BLUE JANEIRO VAR 7 A 12 ACC TELA	Pozzi	CE 10
BLUE JANEIRO VAR 7 A 12 IN SEMPLICE	Pozzi	CE 10
BLUE JAY ACC LIGHT	Dalmatex	CCL
BLUE JAY ACC TELA	Dalmatex	CCL
BLUE JAY IN SEMPLICE	Dalmatex	CCL
BLUE JET  ACC LIGHT	Tat	CI 10/11
BLUE JET  ACC REPS	Tat	CI 10/11
BLUE JET  SEMPLICE	Tat	CI 10/11
BLUE JET TELA + IDRO	Tat	CSP
BLUE JET TELA EXPERT	Tat	CSP
BLUE KIWI ACC LIGHT	Taborelli	CCL
BLUE KIWI ACC TELA	Taborelli	CCL
BLUE KIWI IN SEMPLICE	Taborelli	CCL
BLUE METAL	Dalmatex	CV
BLUE MEXICAN IN SEMPLICE bicolore	Magitex	CCL
BLUE MEXICAN IN SEMPLICE monocolore	Magitex	CCL
BLUE MEXICAN LIGHT bicolore	Magitex	CCL
BLUE MEXICAN LIGHT monocolore	Magitex	CCL
BLUE MEXICAN TELA bicolore	Magitex	CCL
BLUE MEXICAN TELA monocolore	Magitex	CCL
BLUE MOON IN SEMPLICE	Valli	CCL
BLUE OCEAN LIGHT	Frigerio	CE 12
BLUE OCEAN REPS	Frigerio	CE 12
BLUE OCEAN REPS+ idro	Frigerio	CSP
BLUE OCEAN SEMPLICE	Frigerio	CE 12
BLUE POP ACC. REPS	Corti	CV
BLUE POP ACC. STRETCH	Corti	CV
BLUE POP ACC. TELA	Corti	CV
BLUE POP MTP DENSITA 40 FINITO 2 MM CON NS.LOFT	Corti	CV
BLUE POP MTP DENSITA' 40 FINITO 2MM	Corti	CV
BLUE POP SEMPLICE	Corti	CV
BLUE RAIN	Miti	CCL
BLUE REEF ACC  REPS	Frigerio	CE 11
BLUE REEF ACC LIGHT	Frigerio	CE 11
BLUE REEF CRINKLE	Frigerio	CE 11
BLUE REEF CRINKLE LIGHT	Frigerio	CE 11
BLUE REEF IN SEMPLICE	Frigerio	CE 11
BLUE REEF RESINATO	Frigerio	
BLUE ROSE  ACC. TELA	Lange	CV
BLUE ROSE ACC. LIGHT	Lange	CV
BLUE ROSE IN SEMPLICE	Lange	CV
BLUE SAND 1 ACC LIGHT	Lange	CCL
BLUE SAND 1 ACC TELA	Lange	CCL
BLUE SAND 1 IN SEMPLICE	Lange	CCL
BLUE SAND ACC LIGHT	Lange	
BLUE SAND ACC TELA	Lange	CE 10
BLUE SAND CRINKLE IN SEMPLICE	Lange	CE 10
BLUE SAND CRINKLE LIGHT	Lange	CE 10
BLUE SAND IN SEMPLICE	Lange	CE 10
BLUE SAND PE 12 CRINKLE	Raion Inveruno	CE 12
BLUE SAND PE 12 CRINKLE LIGHT	Raion Inveruno	CE 12
BLUE SAND PE 12 light	Raion Inveruno	CE 12
BLUE SAND PE 12 SEMPLICE	Raion Inveruno	CE 12
BLUE SAND REPS	Raion Inveruno	CE 12
BLUE SHOT	Radici Group	CI09/10
BLUE SKY	Dalmatex	CCL
BLUE SKY ACC. TELA NATUZZI	Dalmatex	CSP
BLUE SKY PESANTE	Dalmatex	CSP
BLUE SKY SOFT	Dalmatex	CCL
BLUE SOFT SENZA TELA	Dalmatex	CV
BLUE SOUL ACC. LIGHT COLORATO	Mariani cinese	CV
BLUE SOUL ACC. LIGHT ORO/ARGENTO	Mariani cinese	CV
BLUE SOUL ACC. REPS COLORATO	Mariani cinese	CV
BLUE SOUL ACC. REPS ORO/ARGENTO	Mariani cinese	CV
BLUE SOUL ACC. TELA  ORO ARGENTO	Mariani cinese	CV
BLUE SOUL ACC. TELA COLORATO	Mariani cinese	CV
BLUE SOUL IN SEMPLICE COLORATO	Mariani cinese	CV
BLUE SOUL IN SEMPLICE ORO/ARGENTO	Mariani cinese	CV
BLUE VELVET ACC. LIGHT	My Way	CV
BLUE VELVET ACC. REPS	My Way	CV
BLUE VELVET IN SEMPLICE	My Way	CV
BLUE WAVE	My Way	CCL
BLUISH	Toia	CV
BLUISH BIFACE WASHED	Toia	CV
BOCA BIANCO / NERO	Fillattice	CV
BOCA COLORATI	Fillattice	CV
BOCA RATON ACC. LIGHT	Lange	CV
BOCA RATON ACC. TELA	Lange	CV
BOCA RATON IN SEMPLICE	Lange	CV
BOCA SAND	Lange	CV
BOCA WASHE ACC. LIGHT	Lange	CV
BOCA WASHED ACC. TELA	Lange	CV
BOCA WASHED IN SEMPLICE	Lange	CV
BOLAS ACC. REPS	Namsan Technology	CV
BONG ACC. LIGHT	Lange	CV
BONG ACC. TELA	Lange	CV
BONG IN SEMPLICE	Lange	CV
BOOKER	Dalmatex	CV
BOOTSY RESINATO	Lange	CV
BOOTSY SEMPLICE	Lange	CV
BOOTSY SOFT	Lange	CV
BOOTSY TELA	Lange	CV
BOPSY	Ambiente Uomo	CV
BOREAS ACC. LIGHT	Frigerio	CV
BOREAS ACC. REPS	Frigerio	CV
BOREAS IN SEMPLICE	Frigerio	CV
BOULEVARD	Taborelli	CV
BOWEN	Lange	CV
BOXER COL.NERO	Corti	CV
BOXER COLORATO	Corti	CV
BRAD ACC. TELA  + LAMINA ORO/ARGENTO	Lange	CV
BRAD ACC. TELA + LAMINA COLORATA	Lange	CV
BRAD BOY ACC. TELA	Lange	CCL
BRAD BOY IN SEMPLICE	Lange	CCL
BRAD CRINKLE IN SEMPLICE	Lange	CCL
BRAD GREGGIO IN SEMPLICE	Lange	CSP
BRAD IN SEMPLICE  + LAMINA COLORATA	Lange	CV
BRAD IN SEMPLICE + LAMINA ORO/ARGENTO	Lange	CV
BRAD LIGHT	Lange	CCL
BRAD MADRAS ACC LIGHT	Lange	CE 11
BRAD MADRAS ACC REPS	Lange	CE 11
BRAD MADRAS IN SEMPLICE	Lange	CE 11
BRAD RESINATO	Lange	CCL
BRAD SEMPLICE	Lange	CCL
BRAD STAMPA H. & B. BASSOTTO	Lange	CV
BRAD STRONG  ACC. TELA	Lange	CV
BRAD STRONG ACC. LIGHT	Lange	CV
BRAD STRONG IN SEMPLICE	Lange	CV
BRAD TELA	Lange	CCL
BRADSTONE	Lange	CE 11
BRANDO ACC. DENIM	Lange	CV
BRANDO ACC. LIGHT	Lange	CV
BRANDO ACC. TELA	Lange	CV
BRANDO IN SEMPLICE	Lange	CV
BRANDO PLAYGROUND RESINATO	Corti	CV
BRANDON ACC LIGHT	Corti	CI09/10
BRANDON ACC REPS	Corti	CI09/10
BRANDON BASE KYKO RESINATO	Beccalli	CV
BRANDON IN SEMPLICE	Corti	CI09/10
BRANDON KYKO LIGHT	Beccalli	CV
BRANDON KYKO REPS	Beccalli	CV
BRANDON KYKO RESINATO	Beccalli	CV
BRANDON KYKO SEMPLICE	Beccalli	CV
BRANDON KYKO TELA	Beccalli	CV
BRANDON PLAYGROUND LIGHT	Corti	CV
BRANDON PLAYGROUND REPS	Corti	CV
BRANDON PLAYGROUND SEMPLICE	Corti	CV
BRANDON PLAYGROUND TELA	Corti	CV
BRASCO	Piave	CV
BRAVE	Piave	CV
BRAVE COLORATI	Piave	CV
BRAVE HEART  ACTIVE SEMPLICE	Corti	CV
BRAVE HEART  ACTIVE SOFT	Corti	CV
BRAVE HEART  ACTIVE TELA	Corti	CV
BRAVE HEART ACTIVE TELA MOPLAST TELA	Corti	CV
BRAVE HEART BASE STRETCH ACC.LOFT	Fillattice	CV
BRAVE HEART NEW KUMQUAT REPS	Tat	CV
BRAVE HEART NEW KUMQUAT SEMPLICE	Tat	CV
BRAVE HEART NEW KUMQUAT STRETCH	Tat	CV
BRAVE HEART NEW KUMQUAT TELA MOPLAST	Tat	CV
BRAVE HEART PLAGROUND TELA MOPLAST	Corti	CV
BRAVE HEART PLAYGROUND SEMPLICE	Corti	CV
BRAVE HEART PLAYGROUND SOFT	Corti	CV
BRAVE HEART PLAYGROUND TELA	Corti	CV
BRAVE KYKO	Beccalli	CV
BRAVE TELA	Piave	CV
BRAVE TELA COLORATI	Piave	CV
BRIAN REPS	Gif	CV
BRIAN RESINATO	Gif	CV
BRIAN SEMPLICE	Gif	CV
BRIAN SOFT	Gif	CV
BRISE'	Furpile	CI 11/12
BRIZA  ACC LIGHT	My Way	CCL
BRIZA  ACC TELA	My Way	CCL
BRIZA IN SEMPLICE	My Way	CCL
BROAD REPS	Nero su Nero	CV
BROAD REPS BASE STRETCH	Pizval	CV
BROAD STRETCH	Pizval	CV
BROAD STRETCH NERO SPECIAL	Pizval	CV
BRONZE ACC. DENIM LIGHT DELAVATO	Berto spa	CV
BRONZE DENIM ACC. LIGHT	Berto spa	CV
BRONZE DENIM ACC. TELA	Berto spa	CV
BRONZE DENIM ACC. TELA DELAVATO	Berto spa	CV
BRONZE DENIM IN SEMPLICE	Berto spa	CV
BRONZE DENIM IN SEMPLICE DELAVATO	Berto spa	CV
BRONZE SKY	Corti	CV
BROTHER	Corti	CV
BRUCE REPS	Forma	CV
BRUCE SOFT	Forma	CV
BRYANT	Corti	CV
BUBBA	Piave	CV
BUDDA VELVET ACC. REPS	Namsan Technology	CV
BUDDHA SEMPLICE	Griffine	CV
BUDDHA STRETCH	Griffine	CV
BUDDHA TELA	Griffine	CV
BULGARI ESTERNO ACC. LIGHT + IDRO	Frigerio	CV
BULGARI FODERA RESINATA + IDRO	Frigerio	CV
BULGARI TABORELLI ESTERNO ACC- LIGHT + IDRO	Taborelli	CV
BULGARI TABORELLI FODERA RESIN. + IDRO	Taborelli	CV
BULLET ACC. DENIM NERO	Corti	CSP
BULLET ACC. DENIM NERO + IDRO BEROFIN	Corti	
BULLET ACC. LIGHT	Corti	CCL
BULLET ACC. REPS	Corti	CCL
BULLET ACC. REPS + IDRO BEROFIN	Corti	CSP
BULLET CINZ ACC. LIGHT	Corti	CV
BULLET CINZ ACC. REPS	Corti	CV
BULLET CINZ IN SEMPLICE	Corti	CV
BULLET IN SEMPLICE	Corti	CCL
BULLET METAL COLORATI  IN SEMPLICE	Corti	CCL
BULLET METAL COLORATI  LIGHT	Corti	CCL
BULLET METAL COLORATI  TELA	Corti	CCL
BULLET METAL COLORATO ACC. REPS	Corti	
BULLET METAL oro/argento LIGHT	Corti	CCL
BULLET METAL oro/argento TELA	Corti	CCL
BULLET METAL oro/argentoIN SEMPLICE	Corti	CCL
BULLET OVATTA 80 GR + LIGHT	Corti	CSP
BULLET SNOW FERRAGAMO	Corti	CSP
BULLET TELA	Corti	CCL
BULLET TELA+ MTP 3MM+LIGHT	Corti	CSP
BURBERRY DENIM ACC. BURBERRY DENIM	Gif	CSP
CACHEMIRE SETA DENIM	Papis	CV
CACHEMIRE SETA REPS	Papis	CV
CACHEMIRE SETA RESINATO	Papis	CV
CACHEMIRE SETA SEMPLICE	Papis	CV
CACHEMIRE SETA SOFT	Papis	CV
CALFY	Griffine	CCL
CALFY STERTCH	Griffine	CCL
CALFY TELA	Griffine	CCL
CALYPSO REPS	Lange	CV
CALYPSO RESINATO	Lange	CV
CALYPSO SEMPLICE	Lange	CV
CALYPSO SOFT	Lange	CV
CALYPSO TELA	Lange	CV
CAMON	Taborelli	CV
CAMPIONE 2 PANNO  LIGHT	Styletex	CSP
CAMPIONE 2 PANNO RESINATO	Styletex	CSP
CAMPIONE 2 PANNO SEMPLICE	Styletex	CSP
CAMPIONE 3 PANNO LIGHT	Styletex	CSP
CAMPIONE 3 PANNO RESINATO	Styletex	CSP
CAMPIONE 3 PANNO SEMPLICE	Styletex	CSP
CAMPIONE A DOLCE E GABBANA ACC. LIGHT	Taborelli	CSP
CAMPIONE A DOLCE E GABBANA ACC. TELA	Taborelli	CSP
CAMPIONE A DOLCE E GABBANA IN SEMPLICE	Taborelli	CSP
CAMPIONE B DOLCE E GABBANA ACC LIGHT	Taborelli	CSP
CAMPIONE B DOLCE E GABBANA ACC TELA	Taborelli	CSP
CAMPIONE B DOLCE E GABBANA IN SEMPLICE	Taborelli	CSP
CAMPIONE BLUE SKY ACC.TELA NATUZZI	Dalmatex	CSP
CAMPIONE C DOLCE E GABBANA ACC LIGHT	Taborelli	CSP
CAMPIONE C DOLCE E GABBANA ACC REPS	Taborelli	CSP
CAMPIONE C DOLCE E GABBANA IN SEMPLICE	Taborelli	CSP
CAMPIONE D DOLCE E GABBANA ACC LIGHT	Taborelli	CSP
CAMPIONE D DOLCE E GABBANA ACC TELA	Taborelli	CSP
CAMPIONE D DOLCE E GABBANA IN SEMPLICE	Taborelli	CSP
CAMPIONE E DOLCE E GABBANA ACC LIGHT	Taborelli	CSP
CAMPIONE E DOLCE E GABBANA ACC TELA	Taborelli	CSP
CAMPIONE E DOLCE E GABBANA IN SEMPLICE	Taborelli	CSP
CAMPIONE F DOLCE E GABBANA ACC LIGHT	Taborelli	CSP
CAMPIONE F DOLCE E GABBANA ACC REPS	Taborelli	CSP
CAMPIONE F DOLCE E GABBANA IN SEMPLICE	Taborelli	CSP
CAMPIONE G DOLCE E GABBANA ACC LIGHT	Taborelli	CSP
CAMPIONE G DOLCE E GABBANA ACC REPS	Taborelli	CSP
CAMPIONE G DOLCE E GABBANA IN SEMPLICE	Taborelli	CSP
CAMPIONE H DOLCE E GABBANA ACC LIGHT	Taborelli	CSP
CAMPIONE H DOLCE E GABBANA ACC REPS	Taborelli	CSP
CAMPIONE H DOLCE E GABBANA IN SEMPLICE	Taborelli	CSP
CAMPIONE I DOLCE E GABBANA ACC LIGHT	Taborelli	CSP
CAMPIONE I DOLCE E GABBANA ACC REPS	Taborelli	CSP
CAMPIONE I DOLCE E GABBANA IN SEMPLICE	Taborelli	CSP
CAMPIONE L DOLCE E GABBANA ACC LIGHT	Taborelli	CSP
CAMPIONE L DOLCE E GABBANA ACC REPS	Taborelli	CSP
CAMPIONE L DOLCE E GABBANA IN SEMPLICE	Taborelli	CSP
CAMPIONE M DOLCE E GABBANA ACC LIGHT	Taborelli	CSP
CAMPIONE M DOLCE E GABBANA ACC TELA	Taborelli	CSP
CAMPIONE M DOLCE E GABBANA IN SEMPLICE	Taborelli	CSP
CAMPIONE N DOLCE E GABBANA ACC LIGHT	Frigerio	CSP
CAMPIONE N DOLCE E GABBANA ACC REPS	Frigerio	CSP
CAMPIONE N DOLCE E GABBANA IN SEMPLICE	Frigerio	CSP
CAMPIONE NYLON TRECCIA  IN SEMPLICE	Romano'	CSP
CAMPIONE NYLON TRECCIA  RESINATA	Romano'	CSP
CAMPIONE NYLON TRECCIA ACC. LIGHT	Romano'	CSP
CAMPIONE O DOLCE E GABBANA ACC LIGHT	Frigerio	CSP
CAMPIONE O DOLCE E GABBANA ACC REPS	Frigerio	CSP
CAMPIONE O DOLCE E GABBANA IN SEMPLICE	Frigerio	CSP
CAMPIONE P DOLCE E GABBANA ACC LIGHT	Frigerio	CSP
CAMPIONE P DOLCE E GABBANA ACC REPS	Frigerio	CSP
CAMPIONE P DOLCE E GABBANA IN SEMPLICE	Frigerio	CSP
CAMPIONE RETE ZANZARIERA BERNEDA+VAPO ALLUMINIO	Valli	CSP
"CAMPIONE TECNICO ""E"" PER TOD'S DENIM + IDRO"	Corti	CSP
CANNETTE' ACC. LIGHT	Magitex	CCL
CANNETTE' ACC. TELA	Magitex	CCL
CANNETTE' IN SEMPLICE	Magitex	CCL
CANNETTE' NUOVO RAION tela	Raion Inveruno	CSP
CANNETTE' STEEL  ACC. TELA COLORATI	Raion Inveruno	CCL
CANNETTE' STEEL ACC LIGHT COLORATO	Magitex	CCL
CANNETTE' STEEL ACC LIGHT oro/arg	Magitex	CCL
CANNETTE' STEEL ACC. TELA ORO/ARG	Magitex	CCL
CANNETTE' STEEL IN SEMPLICE COLORATI	Magitex	CCL
CANNETTE' STEEL IN SEMPLICE oro/arg	Magitex	CCL
CANVAGOM SEMPLICE	Clementi	CV
CANVAGOM SOFT	Clementi	CV
CANVAGOM TELA	Clementi	CV
CANVAS A + RESINA	Lange	CSP
CANVAS ACC. TELA	Lange	CCL
CANVAS ACC.LIGHT	Lange	CCL
CANVAS ACC.TELA + FINISS IGNIFUGO SPALM.  BS5852/1	Lange	CSP
CANVAS B + RESINA	Lange	CSP
CANVAS GLASS VALEXTRA	Lange	
CANVAS GREGGIO LIGHT	Lange	CSP
CANVAS GREGGIO SEMPL	Lange	CSP
CANVAS GREGGIO TELA	Lange	CSP
CANVAS IN SEMPLICE	Lange	CCL
CANVAS WASHED ACC LIGHT	Lange	CE09
CANVAS WASHED ACC TELA	Lange	CE09
CANVAS WASHED IN SEMPLICE	Lange	CE09
CAPE CODE ACC. LIGHT	Taborelli	CCL
CAPE CODE ACC. TELA	Taborelli	CCL
CAPE CODE IN SEMPLICE	Taborelli	CCL
CARBONIUM ACC.LIGHT	Dalmatex	CV
CARBONIUM IN SEMPLICE	Dalmatex	CV
CARGO ACC. LIGHT	Lange	CCL
CARGO ACC. TELA	Lange	CCL
CARGO GREGGIO purgato SEMPLICE	Lange	CSP
CARGO IN SEMPLICE	Lange	CCL
CARGO PRONTO TINTA SEMPLICE	Lange	CSP
CARIBA GREGGIO LIGHT	Forma	CV
CARIBA GREGGIO TELA	Forma	CV
CARLITO ACC. WALLY	Carvico	CV
CARLITO BIANCO	Carvico	CCL
CARLITO BIANCO +MTP 1,50 D.40 2 PASSAGGI	Carvico	CSP
CARLITO BIANCO CON LAVOR.WILD VELVET	Carvico	CSP
CARLITO BIANCO LAV. NOVARESIN	Carvico	CSP
CARLITO COL.BIANCO +MTP1 D.24 2 PASSAGGI	Carvico	CSP
CARLITO COL.NERO + MTP 1  D.24 2 PASAGGI.	Carvico	CSP
CARLITO COL.NERO+MTP 1,50 D.40 2 PASAGGI.	Carvico	CSP
CARLITO COLORATI	Carvico	CCL
CARLITO COLORATO + MTP 1 D.24 2 PASSAGGI	Carvico	CSP
CARLITO COLORATO + MTP 1,50 D.40 2 PASSAGGI	Carvico	CSP
CARLITO COLORATO CON LAVOR.WILD VELVET	Carvico	CSP
CARLITO COLORATO LAV. NOVARESIN	Carvico	CSP
CARLITO NERO	Carvico	CCL
CARLITO NERO CON LAVOR.WILD VELVET	Carvico	CSP
CARLITO NERO LAV. NOVARESIN	Carvico	CSP
CARLITO STAMPATO ARTEA CAFE NOIR	Carvico	
CARMEN AC. LIGHT	My Way	CV
CARMEN ACC. REPS	My Way	CV
CARMEN IN SEMPLICE	My Way	CV
CARVER ACC. DENIM BIANCO	Sitip	CCL
CARVER ACC. TELA	Sitip	CCL
CARVER LIGHT	Sitip	CCL
CARVER METAL IN SEMPLICE	Sitip	CV
CARVER METAL LIGHT	Sitip	CV
CARVER METAL REPS	Sitip	CV
CARVER PRONTO TINTA	Sitip	CSP
CARVER REPS	Sitip	CCL
CARVER SEMPLICE	Sitip	CCL
CATCH VAR. 1/2/3/4	Taborelli	CV
CATCH VAR.5/6/7/8/	Taborelli	CV
CATWALK REPS	Itam	CV
CATWALK SEMPLICE	Itam	CV
CATWALK SOFT	Itam	CV
CATWALK TELA	Itam	CV
CAVALLERY REPS	Molteni	CV
CAVALLERY SEMPLICE	Molteni	CV
CAVALLERY SOFT	Molteni	CV
CAVALLERY SPALMATO	Molteni	CV
CAYENNE	Lange	CV
CAYMAN ACC. LIGHT	Lange	CV
CAYMAN ACC. TELA	Lange	CV
CAYMAN IN SEMPLICE	Lange	CV
CERVO ACC. LIGHT	Armac.com srl	CV
CERVO ACC. REPS	Armac.com srl	CV
CERVO IN SEMPLICE	Armac.com srl	CV
CHALK ACC. LIGHT	Magitex	CV
CHALK ACC. REPS BEROFIN	Magitex	CV
CHALK ACC.MTP 2MM	Magitex	CV
CHALK DENIM	Magitex	CV
CHALK RESINATO	Magitex	CV
CHALK SEMPLICE	Magitex	CV
CHALK SOFT	Magitex	CV
CHAMBERS B.CO APPRETTATO	Heat Coat	CSP
CHAMBERS B.CO DOPPIA BRINATURA + APPRETTO	Heat Coat	CSP
CHAMBERS BIANCO NON TINTO	Heat Coat	CCL
CHAMBERS bianco STAMPATO ARMANI	Heat Coat	CSP
CHAMBERS BIANCO TINTO DA VIERRE	Heat Coat	CCL
CHAMBERS COLORATO	Heat Coat	CCL
CHAMBERS COLORATO DOPPIA BRINATURA + APPRETTO	Heat Coat	CSP
CHAMBERS COLORATO STAMPATO ARMANI	Heat Coat	CSP
CHAMBERS FIVE tinto	Heat Coat	CSP
CHAMBERS JUSTIN METAL ACC. TELA	My Way	CV
CHAMBERS METAL COLORATO	Heat Coat	CCL
CHAMBERS METAL ORO/ARGENTO	Heat Coat	CCL
CHAMBERS TAFFETA'	Heat Coat	CE 12
CHAMBERS ZIGGY METAL	Dalmatex	CV
CHANDLER LOFT	Toia	CV
CHANDLER REPS	Toia	CV
CHANDLER SEMPLICE	Toia	CV
CHANDLER SPALMATO	Toia	CV
CHAOS	Carvico	CV
CHARISMA BASE 1 ACC LIGHT	Sitip	CI09/10
CHARISMA BASE 1 ACC REPS	Sitip	CI09/10
CHARISMA BASE 1 SEMPLICE	Sitip	CI09/10
CHARISMA BASE 2 ACC LIGHT	Corti	CI09/10
CHARISMA BASE 2 ACC TELA	Corti	CI09/10
CHARISMA BASE 2 ACC. REPS	Corti	
CHARISMA BASE 2 IN SEMPLICE	Corti	CI09/10
CHARISMA BASE 3 ACC LIGHT	Sitip	CI09/10
CHARISMA BASE 3 ACC REPS	Sitip	CI09/10
CHARISMA BASE 3 IN SEMPLICE	Sitip	CI09/10
CHARISMA BASE 4 ACC LIGHT	Corti	CI09/10
CHARISMA BASE 4 ACC TELA	Corti	CI09/10
CHARISMA BASE 4 IN SEMPLICE	Corti	CI09/10
CHARISMA BASE 5 ACC LIGHT	Beccalli	CI09/10
CHARISMA BASE 5 ACC REPS	Beccalli	CI09/10
CHARISMA BASE 5 IN SEMPLICE	Beccalli	CI09/10
CHARISMA BASE 5 RESINATO + IDRO BEROFIN	Beccalli	
CHARLES	Lange	CV
CHARLIZE ACC REPS	Namsan Technology	CI09/10
CHARLY LIGHT	Corti	CV
CHARLY REPS	Corti	CV
CHARLY RESINATO	Corti	CV
CHARLY SEMPLICE	Corti	CV
CHARME ACC LIGHT	Dalmatex	CCL
CHARME ACC TELA	Dalmatex	CCL
CHARME BASKET LIGHT	Dalmatex	CCL
CHARME BASKET TELA	Dalmatex	CCL
CHARME BOUCLE'	Dalmatex	CCL
CHARME IN SEMPLICE	Dalmatex	CCL
CHARME MESH ACC LIGHT	My Way	CCL
CHARME MESH ACC TELA	My Way	CCL
CHARME MESH IN SEMPLICE	My Way	CCL
CHARME SNOW	Dalmatex	CSP
CHARME TRAPUNTATO DIAMANTE 2	Dalmatex	CSP
CHARME TRAPUNTATO DIAMANTE VERTICALE	Dalmatex	CSP
CHARMS	Clerprem	CV
CHEEKY	Dalmatex	CCL
CHESTER	Corti	CV
CHEVRON  IN SEMPLICE	Taborelli	CI 10/11
CHEVRON ACC LIGHT	Taborelli	CI 10/11
CHEVRON ACC REPS	Taborelli	CI 10/11
CHEVRON CRINKLE ACC LIGHT	Taborelli	CI 10/11
CHEVRON CRINKLE IN SEMPLICE	Taborelli	CI 10/11
CHIC FLOWER ACC. LIGHT	Beccalli	CV
CHIC FLOWER ACC. REPS	Beccalli	CV
CHIC FLOWER IN SEMPLICE	Beccalli	CV
CHIC TWILL ACC DENIM+IDRO	Frigerio	CE 11
CHIC TWILL ACC LIGHT	Frigerio	CE 11
CHIC TWILL IN SEMPLICE	Frigerio	CE 11
CHICCO DENIM	Lange	CV
CHICCO REPS	Lange	CV
CHICCO RESINATO	Lange	CV
CHICCO SEMPLICE	Lange	CV
CHICCO SOFT	Lange	CV
CHICCO TELA	Lange	CV
CHILL	Clerprem	CV
CHIMMY	My Way	CV
CHINZE' DENIM	Tat	CV
CHINZE' REPS	Tat	CV
CHOCO	Tessil Due	CV
CHOCOLAT LIGHT	Arnetta	CI 11/12
CHOCOLAT REPS	Arnetta	CI 11/12
CHOCOLAT SEMPLICE	Arnetta	CI 11/12
CHOCOLAT TELA	Arnetta	CI 11/12
CHRONO CHIC ACC LIGHT	Tat	CE 12
CHRONO CHIC ACC REPS	Tat	CE 12
CHRONO CHIC SEMPLICE	Tat	CE 12
CHRONO RACE  PE 12	Carvico	CE 12
CHUCK	Lange	CV
CIKO BASE ACTIVE SEMPLICE	Corti	CV
CIKO BASE ACTIVE SOFT	Corti	CV
CIKO BASE ACTIVE TELA	Corti	CV
CIKO BASE NEW KUMQUAT LOFT	Tat	CV
CIKO BASE NEW KUMQUAT REPS	Tat	CV
CIKO BASE NEW KUMQUAT SEMPLICE	Tat	CV
CIKO BASE PLAYGROUND SEMPLICE	Corti	CV
CIKO BASE PLAYGROUND SOFT	Corti	CV
CIKO BASE PLAYGROUND TELA	Corti	CV
CINZ ACC STRETCH	Jersey Lomellina	CSP
CINZ REPS	Jersey Lomellina	CE 12
CINZ SEMPLICE	Jersey Lomellina	CSP
CIRO	Antares	
CITY BLUES ACC. LIGHT	Lange	CV
CITY BLUES ACC. TELA	Lange	CV
CITY BLUES IN SEMPLICE	Lange	CV
CLARENCE RESINATO	Toia	CV
CLARENCE SEMPLICE	Toia	CV
CLARENCE SOFT	Toia	CV
CLARENCE TELA	Toia	CV
CLIFF	Griffine	CV
CLIFF METAL COLORATI	Piave	CV
CLIFF METAL ORO ARGENTO	Piave	CV
CLIFF STRETCH	Griffine	CV
CLIFF TELA	Griffine	CV
CLIPPER + MTP 3MM +LIGHT	Lazzati	CSP
CLIPPER ACC DENIM + IDRO	Lazzati	CSP
CLIPPER ACC LIGHT	Corti	CE 11
CLIPPER ACC REPS	Corti	
CLIPPER IN SEMPLICE	Corti	CE 11
CLIPPER PRONTO STAMPA  SEMPLICE	Lazzati	CSP
CLIPPER+ OVATTA 60 +LIGHT	Lazzati	CSP
CLOSED	Lange	CV
CLOSED ABBIGLIAMENTO	Taborelli	CV
CLUBBIN LIGHT	Clementi	CV
CLUBBIN SEMPLICE	Clementi	CV
CLUBBIN TELA	Clementi	CV
COCOA ACC. LIGHT	Lange	CV
COCOA ACC. TELA	Lange	CV
COCOA IN SEMPLICE	Lange	CV
COCONE VELVET ACC. REPS	My Way	CV
COLEMAN	Lange	CV
COLIN	Sitip	CV
COLOR LIFE LIGHT	Beccalli	CV
COLOR LIFE PLISSE'	Beccalli	CV
COLOR LIFE REPS	Beccalli	CV
COLOR LIFE RESINATO	Beccalli	CV
COLOR LIFE SEMPLICE	Beccalli	CV
COLOR LIFE TELA	Beccalli	CV
COLORADO BAY  IN SEMPLICE	Namsan Technology	CV
COLORADO BAY ACC. LIGHT	Namsan Technology	CV
COLORATI		CV
COLORDO BAY ACC. REPS	Namsan Technology	CV
COLOUR SCUBA	Carvico	CI 11/12
COLOUR VICHY ACC LIGHT BEROFIN	Taborelli	CE 11
COLOUR VICHY ACC REPS BEROFIN	Taborelli	CE 11
COLOUR VICHY IN SEMPLICE	Taborelli	CE 11
CONCEPT ACC LIGHT +. MTP 0,5	Miti	CV
CONCEPT ACC. MTP 1MM	Miti	CV
CONCEPT ACC.LIGHT + MTP 1 MM	Miti	CV
CONCEPT ACC.MTP 0,5	Miti	CV
CONCEPT SEMPLICE	Miti	CCL
CONCEPT STRETCH	Miti	CCL
CONCEPT TELA	Miti	CCL
CONTEMPLATION ACC. LIGHT	Lange	CV
CONTEMPLATION ACC. TELA	Lange	CV
CONTEMPLATION IN SEMPLICE	Lange	CV
COOL BAY ACC LIGHT	Pietro Mariani	CE 10
COOL BAY ACC TELA	Pietro Mariani	CE 10
COOL BAY IN SEMPLICE	Pietro Mariani	CE 10
COOL MIX COLORATO	Beccalli	CV
COOL PIX ACC. LIGHT	Taborelli	CV
COOL PIX ACC. TELA	Taborelli	CV
COOL PIX IN SEMPLICE	Taborelli	CV
COOL SOFT	Uco	CV
COOL TELA	Uco	CV
CORAL BASE BIANCA LIGHT	Mariani cinese	CV
CORAL BASE BIANCA REPS	Mariani cinese	CV
CORAL BASE COLORATA LIGHT	Mariani cinese	CV
CORAL BASE COLORATA REPS	Mariani cinese	CV
CORAL BAY	Beccalli	CV
CORAL SANDS ACC TELA	Lange	CE 11
CORAL SANDS IN SEMPLICE	Lange	CE 11
CORAL SKY	Dalmatex	CV
CORALLO ACC LIGHT BEROFIN	Gitalia	CSP
CORCOVADO ACC. LIGHT	Taborelli	CV
CORCOVADO ACC. REPS	Taborelli	CV
CORCOVADO IN SEMPLICE	Taborelli	CV
CORD MESH	Heat Coat	CE 11
CORD MESH TINTO DA NOI	Heat Coat	CE 12
COSMIC	Piave	CV
COTONE ECONOMICO X BIASIA GREGGIO	Lange	CSP
COTTON JAM ACC. LIGHT	Lange	CCL
COTTON JAM ACC. REPS	Lange	CCL
COTTON JAM RESINATO	Lange	CCL
COTTON JAM SEMPLICE	Lange	CCL
COTTON JAM SOFT	Lange	CCL
COTTON JAM TELA	Lange	CCL
COTTON MYMETIC ACC LIGHT	Lange	
COTTON MYMETIC ACC TELA	Lange	CSP
COTTON MYMETIC IN SEMPLICE	Lange	CSP
COTTONSTONE ACC LIGHT	Lange	CE 11
COTTONSTONE ACC TELA	Lange	CE 11
COTTONSTONE CRINKLE	Lange	CE 11
COTTONSTONE CRINKLE LIGHT	Lange	CE 11
COTTONSTONE IN SEMPLICE	Lange	CE 11
COTTONSTONE REPS	Lange	CE 11
CRAIG	My Way	CV
CREPE IN SEMPLICE	Beccalli	CV
CREPE METAL ACC LOFT COLORATI	Carvico	CV
CREPE METAL ACC LOFT ORO/ARG.	Carvico	CCL
CREPE METAL ACC REPS COLORATI	Carvico	CV
CREPE METAL ACC REPS ORO/ARG.	Carvico	CCL
CREPE REPS	Beccalli	CV
CREPE RESINATO	Beccalli	CV
CREPE SILVER ACC. LOFT	Taborelli	CCL
CREPE SILVER ACC. REPS	Taborelli	CCL
CREPE SILVER IN SEMPLICE	Taborelli	CCL
CREPE SOFT	Beccalli	CV
CREPE STRETCH ACC. LIGHT	Eurojersey	CCL
CREPE STRETCH ACC. REPS	Eurojersey	CCL
CREPE STRETCH IN SEMPLICE	Eurojersey	CCL
CREPE TELA	Beccalli	CV
CRINCLE REPS	My Way	CV
CRINCLE RESINATO	My Way	CV
CRINCLE SEMPLICE	My Way	CV
CRINCLE SOFT	My Way	CV
CRINKLE ACC. LIGHT	Corti	CV
CRINKLE ACC. REPS	Corti	CV
CRINKLE FIVE	Corti	CV
CRINKLE IN SEMPLICE	Corti	CV
CRINKLE NINE	Sat idea	CV
CRINKLE ONE	Corti	CV
CRINKLE SEVEN COL CHIARI	Corti	CV
CRINKLE SEVEN COL SCURI	Corti	CV
CROCE + SWAROSKI LIGHT	Clementi	CV
CROCE + SWAROSKI RESINATO	Clementi	CV
CROCE + SWAROSKI SEMPLICE	Clementi	CV
CROCE + SWAROSKI TELA	Clementi	CV
CROCKER	Corti	CI 11/12
CROCO	Tat	CV
CROCO FELT	Lanificio di soci	CI 11/12
CROCO MESH	Piave	CV
CROCO STRETCH	Tat	CV
CROSBY REPS	Tat	CV
CROSBY STRETCH	Tat	CV
CRYSTAL ACC.LIGHT	Borgini	CV
CRYSTAL ACC.TELA	Borgini	CV
CUBAN ACC. LIGHT	Lange	CV
CUBAN ACC. TELA	Lange	CV
CUBAN IN SEMPLICE	Lange	CV
CULT ACC. LIGHT	Lange	CV
CULT ACC. TELA	Lange	CV
CULT IN SEMPLICE	Lange	CV
DAINO  STONE ACC. GARDEN	Mariani cinese	CV
DAKOTA	Miti	CV
DAKU ACC. TELA	Raion Inveruno	CV
DAKU ACC.LIGHT	Raion Inveruno	CV
DAKU IN SEMPLICE	Raion Inveruno	CV
DAMASK REPS	Beccalli	CV
DAMASK RESINATO	Beccalli	CV
DAMASK SEMPLICE	Beccalli	CV
DAMASK SOFT	Beccalli	CV
DARK CROCO LIGHT	Taborelli	CI 11/12
DARK CROCO LYCRA	Taborelli	CI 11/12
DARK CROCO REPS	Taborelli	CI 11/12
DARK CROCO SEMPLICE	Taborelli	CI 11/12
DARK DIAMOND ART 62 ACC LIGHT	Corti	
DARK DIAMOND ART 62 ACC TELA	Corti	CI 10/11
DARK DIAMOND ART 62 IN SEMPLICE	Corti	CI 10/11
DARK ICE LIGHT	Taborelli	CI 11/12
DARK ICE REPS	Taborelli	CI 11/12
DARK ICE SEMPLICE	Taborelli	CI 11/12
DARK SKIN ART  54 ACC REPS	Taborelli	CI 10/11
DARK SKIN ART 54 ACC LIGHT	Taborelli	CI 10/11
DARK SKIN ART 54 IN SEMPLICE	Taborelli	CI 10/11
DARK STRETCH LIGHT	Carvico	CI 11/12
DARK STRETCH reps	Carvico	CI 11/12
DARK STRETCH SEMPLICE	Carvico	CI 11/12
DARREN	Lange	CV
DAVIS	Griffine	CV
DAVISON LIGHT	Corti	CV
DAVISON REPS	Corti	CV
DAVISON RESINATO	Corti	CV
DAVISON SEMPLICE	Corti	CV
DAVISON SOFT	Corti	CV
DAYAK IN SEMPLICE	Pietro Mariani	CV
DAYAK RESINATO	Pietro Mariani	CV
DAYAK SOFT	Pietro Mariani	CV
DAYAK TELA	Pietro Mariani	CV
DAYO BIANCO PRONTO TINTA	Lange	CV
DAYO COLORATO	Lange	CV
DAYO GREGGIO	Lange	CV
DAYTON (VECCHIO)ACC. LIGHT	Lange	CV
DAYTON (VECCHIO)IN SEMPLICE	Lange	CV
DAYTON (VECCHIO)RESINATO	Lange	CV
DAYTON (VECCHIO)SOFT	Lange	CV
DAYTON (VECCHIO)TELA	Lange	CV
DAYTON ACC LIGHT	Corti	CE 11
DAYTON ACC REPS	Corti	CE 11
DAYTON IN SEMPLICE	Corti	CE 11
DAYTON PURGATO SEMPLICE	Corti	CSP
DEEP STONE	Corti	CI 10/11
DEEP STONE  CRINKLE	Corti	CI 10/11
DELIGHT DENIM	Ripa	CCL
DELIGHT REPS	Ripa	CCL
DELIGHT SEMPLICE	Ripa	CCL
DELIGHT STRETCH	Ripa	CCL
DENIM BIANCO H.& B BASSOTTO	Lange	CSP
DENIM BIANCO SUPERVERNICE  FENDI	Lange	CSP
DENIM BURBERRY ACC. LIGHT + IDRO	Gif	CSP
DENIM BURBERRY ACC. LIGHT + IDRO CAMPION.	Gif	CSP
DENIM BURBERRY ACC. TELA + IDRO	Gif	CSP
DENIM BURBERRY ACC. TELA + IDRO CAMPION.	Gif	CSP
DENIM BURBERRY IN SEMPL.+IDRO	Gif	CSP
DENIM BURBERRY IN SEMPL.+IDRO CAMPION.	Gif	CSP
DENIM BURBERRY IN SEMPLICE + IDRO	Gif	CSP
DENIM CHEVRON  ACC LIGHT	Frigerio	CI 10/11
DENIM CHEVRON  CRINKLE ACC LIGHT	Frigerio	CI 10/11
DENIM CHEVRON  CRINKLE SEMPLICE	Frigerio	CI 10/11
DENIM CHEVRON  IN SEMPLICE	Frigerio	CI 10/11
DENIM CHEVRON ACC REPS	Frigerio	CI 10/11
DENIM CRINKLE vecchio IN SEMPLICE	Gif	CCL
DENIM FIVE   CRINKLE LIGHT	Frigerio	CI 10/11
DENIM FIVE  ACC LIGHT	Frigerio	CI 10/11
DENIM FIVE  CRINKLE SEMPLICE	Frigerio	
DENIM FIVE  IN SEMPLICE	Frigerio	CI 10/11
DENIM FIVE ACC REPS	Frigerio	CI 10/11
DENIM GG DECOLORATO + TINTURA THE	Taborelli	CE 12
DENIM GLASS + MOORE	Italdenim	CSP
DENIM GLASS ACC.LIGHT	Italdenim	CCL
DENIM GLASS ACC.TELA	Italdenim	CCL
DENIM GLASS IN SEMPLICE	Italdenim	CCL
DENIM NERO + RESINATURA	Lange	
DENIM ONE  ACC LIGHT	Frigerio	CI 10/11
DENIM ONE  ACC REPS	Frigerio	CI 10/11
DENIM ONE  CRINKLE IN SEMPLICE	Frigerio	
DENIM ONE  CRINKLE LIGHT	Frigerio	CI 10/11
DENIM ONE IN SEMPLICE	Frigerio	CI 10/11
DENIM SPALMATO BERNEDA ACC TELA	Lange	CSP
DENIM VICHY ACC LIGHT	Taborelli	CE 11
DENIM VICHY ACC REPS	Taborelli	CE 11
DENIM VICHY IN SEMPLICE	Taborelli	CE 11
DENIRO	Di.Bi.Ci.	CV
DENNIS ACC. DENIM + IDRO	Uco	CSP
DENNIS ACC. DENIM BIANCO	Lange	CSP
DENNIS ACC. DENIM BIANCO + IDRO	Uco	CSP
DENNIS ACC. DENIM TINTO IDRO BEROFIN	Uco	CSP
DENNIS ACC. LIGHT	Lange	CCL
DENNIS ACC. MTP 3MM	Uco	CSP
DENNIS ACC. TELA + IDRO	Uco	CSP
DENNIS CRINKLE base colorata ACC LIGHT	Lange	CSP
DENNIS CRINKLE base colorata IN SEMPLICE	Lange	CCL
DENNIS CRINKLE VAR 14 SEMPLICE	Lange	CE 12
DENNIS CRINKLE VAR 14 SEMPLICE LIGHT	Lange	CE 12
DENNIS DENIM GREGGIO	Uco	CSP
DENNIS DENIM NERO	Uco	CSP
DENNIS REPS	Lange	CCL
DENNIS RESINATO	Uco	CCL
DENNIS SEMPLICE	Lange	CCL
DENNIS SOFT	Uco	CCL
DENNIS STEEL SOFT	Uco	CV
DENNIS STEEL TELA	Uco	CV
DENNIS STRETCH ACC. LIGHT	Tat	CCL
DENNIS STRETCH ACC. REPS	Tat	CCL
DENNIS STRETCH ACC. STRETCH	Tat	CCL
DENNIS STRETCH SEMPLICE	Tat	CCL
DENNIS STRETCH TELA	Tat	CCL
DENNIS TELA	Lange	CCL
DENNIS VAR 14 SECRET BIANCO SEMPLICE	Lange	CE 12
DENNIS VAR 14 SECRET BIANCOACC. REPS	Lange	
DENNIS VAR 14 SECRET BIANCOACC. TELA	Lange	CE 12
DENZEL RESINATO	My Way	CV
DENZEL SEMPLICE	My Way	CV
DENZEL SOFT	My Way	CV
DENZEL TELA	My Way	CV
DERBY ACC. LIGHT	Lange	CCL
DERBY ACC. LIGHT COL. NERO/MEDI	Lange	CCL
DERBY COL. SCURI ACC. LIGHT	Lange	CCL
DERBY RESINATA BEROFIN	Lange	CCL
DERBY TINTO DA NOI RESINATO	Lange	CSP
DEREK ACC. LIGHT	Lange	CV
DEREK ACC. TELA	Lange	CV
DEREK SEMPLICE	Lange	CV
DETROIT ACC LIGHT	Tat	CE 10
DETROIT ACC TELA	Tat	CE 10
DETROIT IN SEMPLICE	Tat	CE 10
DEXTER LIGHT	Sitip	CV
DEXTER OVATTA	Corti	CV
DEXTER REPS	Sitip	CV
DEXTER SEMPLICE	Sitip	CV
DEXTER VECCHIO	Corti	CV
DIAMOND ACC. LIGHT LAMINA COLORATA	Taborelli	CV
DIAMOND ACC. TELA  LAMINA COLORATA	Taborelli	CV
DIAMOND ACC. TELA  LAMINA ORO/ARG.	Taborelli	CV
DIAMOND ACC.LIGHT LAMINA ORO/ARG.	Taborelli	CV
DIAMOND IN SEMPLICE LAM.ORO/ARG.	Taborelli	CV
DIAMOND IN SEMPLICE LAMONA COLORATA	Taborelli	CV
DIRTY METAL LYCRA	Mariani cinese	CV
DIRTY METAL REPS	Mariani cinese	CV
DIRTY METAL RESINATO	Mariani cinese	CV
DIRTY METAL SEMPLICE	Mariani cinese	CV
DIRTY METAL TELA	Mariani cinese	CV
DIRTY SUEDE	Mariani cinese	CV
DOG	Taborelli	CV
DONTY	Griffine	CV
DOO JAM  BRONZO	Corti	CV
DOO JAM COL.ORO/ARGENTO	Corti	CV
DOPPIA LYCRA+ALVEOLIT FORATO	Eurojersey	CSP
DOPPIO SCUBA BIANCO BIANCO	Carvico	CV
DOPPIO SCUBA BIANCO COLORATI	Carvico	CV
DOPPIO SCUBA BIANCO NERO	Carvico	CV
DOPPIO SCUBA COLORATI	Carvico	CV
DOPPIO SCUBA NERO COLORATI	Carvico	CV
DOPPIO SCUBA NERO NERO	Carvico	CV
DOUBLE CANVAS ACC. TELA	Lange	CCL
DOUBLE CANVAS ACC.LIGHT	Lange	CCL
DOUBLE CANVAS BATIK	Lange	CSP
DOUBLE CANVAS GREGGIO light	Lange	CSP
DOUBLE CANVAS GREGGIO SEMPLICE	Lange	CSP
DOUBLE CANVAS GREGGIO TELA	Lange	CSP
DOUBLE CANVAS IN SEMPLICE	Lange	CCL
DOUBLE CANVAS WASHED ACC LIGHT	Lange	CE 11
DOUBLE CANVAS WASHED ACC TELA	Lange	CE 11
DOUBLE CANVAS WASHED IN SEMPLICE	Lange	CE 11
DOUBLE FELT	Fir spa	CV
DOUBLE FUNNY LIGHT	Taborelli	CI 11/12
DOUBLE FUNNY REPS	Taborelli	CI 11/12
DOUBLE FUNNY SEMPLICE	Taborelli	CI 11/12
DOUBLE GLASS	Lange	CCL
DOUBLE JUTA ACC. LIGHT VAR.2	Lange	CCL
DOUBLE JUTA ACC. TELA VAR. 2	Lange	CCL
DOUBLE JUTA COLARATA ACC LIGHT	Lange	CCL
DOUBLE JUTA COLORATA ACC TELA	Lange	CCL
DOUBLE JUTA COLORATA IN SEMPLICE	Lange	CCL
DOUBLE JUTA CRINKLE	Lange	
DOUBLE JUTA CRINKLE ACC LIGHT	Lange	CE 10
DOUBLE JUTA CRINKLE LIGHT var 2	Lange	CE 12
DOUBLE JUTA CRINKLE var 2	Lange	
DOUBLE JUTA IN SEMPLICE VAR.2	Lange	CCL
DOUBLE JUTA MORBIDA COLORATA LIGHT	Lange	
DOUBLE JUTA MORBIDA COLORATA SEMPLICE	Lange	
DOUBLE JUTA MORBIDA LIGHT VAR. 2	Lange	
DOUBLE JUTA MORBIDA SEMPLICE VAR.2	Lange	
DOUBLE JUTA RESINATA	Lange	CCL
DOUBLE JUTA RESINATA VAR. 2	Lange	CCL
DOUBLE SCUBA NUOVO	Carvico	CI 11/12
DOUBLE SOFT LIGHT	Griffine	CI 11/12
DOUBLE SOFT SEMPLICE	Griffine	CI 11/12
DOUBLE STONE	Lange	
DOUBLE STONE LIGHT	Lange	CE 12
DOUBLE STONE TELA	Lange	CE 12
DOUBLE STONE VAR 1 SECRET B.CO LIGHT	Lange	CE 12
DOUBLE STONE VAR 1 SECRET B.CO SEMPLICE	Lange	CE 12
DOUBLE STONE VAR 1 SECRET B.CO TELA	Lange	CE 12
DOUBLE VELOUR TINTURA DOPPIA	Ciemme	CI 10/11
DOUGLAS	Corti	CV
DREAM	Toia	CV
DREAM  LOFT	Taborelli	CV
DREAM NIGHT ACC LIGHT	Corti	CE 10
DREAM NIGHT ACC TELA	Corti	
DREAM NIGHT IN SEMPLICE	Corti	CE 10
DREAM REPS	Taborelli	CV
DREAM semplice	Taborelli	CV
DRILLSTONE ACC LIGHT	Lange	CE 11
DRILLSTONE ACC REPS	Lange	CE 11
DRILLSTONE CRINKLE	Lange	CE 11
DRILLSTONE CRINKLE ACC LIGHT	Lange	CE 11
DRILLSTONE IN SEMPLICE	Lange	CE 11
DRILLSTONE TELA	Lange	CE 11
DUKE IN SEMPLICE	Corti lanificio	CV
DUKE REPS	Corti lanificio	CV
DUKE RESINATO	Corti lanificio	CV
DUKE RESINATO 1	Corti lanificio	CV
DUKE RESINATO 2	Corti lanificio	CV
DUKE RESINATO 3	Corti lanificio	CV
DUKE SOFT	Corti lanificio	CV
DUNCAN ACC. LIGHT	Corti	CV
DUNCAN ACC.REPS	Corti	CV
DUNCAN IN SEMPLICE	Corti	CV
DUNK SCUBA 1,5 FINISS IGNIFUGO IMMERS. BS5852/1	Carvico	CSP
DUNK SCUBA 2,5 FINISS IGNIFUGO IMMERS. BS5852/1	Carvico	CSP
DUNK SCUBA BALLY STAMPA INK JET	Carvico	
DUNK SCUBA BALLY STAMPA ROTATIVA	Carvico	
DUNK SCUBA BIANCO	Carvico	CCL
DUNK SCUBA COLORATI	Carvico	CCL
DUNK SCUBA NERO	Carvico	CCL
DUSTY LYCRA	Mariani cinese	CV
DUSTY REPS	Mariani cinese	CV
DUSTY RESINATO	Mariani cinese	CV
DUSTY SEMPLICE	Mariani cinese	CV
DUSTY TELA	Mariani cinese	CV
DYLAN X ALMENO 120 MT X COLORE	Clementi	CV
DYTON (VECCHIO)RESINATO	Lange	CV
DYTON (VECCHIO)SEMPLICE	Lange	CV
DYTON (VECCHIO)TELA	Lange	CV
DYTON /VECCHIO)SOFT	Lange	CV
DYTON(VECCHIO) LIGHT	Lange	CV
EAGLE	Itam Mi	CV
EARTH	Taborelli	CV
EBONY	Ambiente Uomo	CV
EDDIE SOFT	Forma	CV
EDDIE TELA	Forma	CV
ELDORADO ACC. LIGHT  ORO/ARGENTO	Lange	CV
ELDORADO ACC. LIGHT COLORATO	Lange	CV
ELDORADO ACC. TELA COLORATO	Lange	CV
ELDORADO ACC. TELA ORO/ARGENTO	Lange	CV
ELDORADO IN SEMPLICE  ORO/ARGENTO	Lange	CV
ELDORADO IN SEMPLICE COLORATO	Lange	CV
ELLIOT	Piave	CV
ELLIOT BIANCO	Piave	CV
ELLIOT NERO	Piave	CV
ELVIS	Corti	CV
ENTERPRISE ACC LIGHT	Corti	CI09/10
ENTERPRISE ACC REPS	Corti	CI09/10
ENTERPRISE ACC. DENIM + IDRO BEROFIN	Corti	
ENTERPRISE ACC. DENIM NERO	Corti	CSP
ENTERPRISE ACC. REPS + IDRO BEROFIN	Corti	CSP
ENTERPRISE IN SEMPLICE	Corti	CI09/10
ESQUIRE	Beccalli	CV
ESSIEN	Lange	CV
ESTEBAN	Maglificio Tgv	CV
ETAN	Lange	CV
ETAN  TINTO SOFT + LAMINA STEEL + IDRO	Lange	CV
ETAN METAL SOFT IDRO	Lange	CV
ETHAN  ACC. REPS	Beccalli	CV
ETHAN ACC. LIGHT	Beccalli	CV
ETHAN IN SEMPLICE	Beccalli	CV
EVANS RESINATO	Gif	CV
EVANS SEMPLICE	Gif	CV
EVANS SOFT	Gif	CV
EVANS TELA	Gif	CV
EXCALIBUR ART 71 ACC LIGHT	Corti	CI 10/11
EXCALIBUR ART 71 ACC REPS	Corti	CI 10/11
EXCALIBUR ART 71 IN SEMPLICE	Corti	CI 10/11
FANDANGO ACC. LIGHT	Tat	CI09/10
FANDANGO ACC. REPS	Tat	CI09/10
FANDANGO IN SEMPLICE	Tat	CI09/10
FANDANGO PRONTO STAMPA SEMPLICE	Tat	CCL
FANDANGO STRETCH ACC. LIGHT	Tat	CI09/10
FANDANGO STRETCH ACC. REPS	Tat	CI09/10
FANDANGO STRETCH IN SEMPLICE	Tat	CI09/10
FAST GOLD  IN SEMPLICE	Corti	CI 10/11
FAST GOLD ACC LIGHT	Corti	CI 10/11
FAST GOLD ACC REPS	Corti	CI 10/11
FAST RACE ACC LIGHT	Lazzati	CE 11
FAST RACE ACC REPS	Lazzati	CE 11
FAST RACE IN SEMPLICE	Lazzati	CE 11
FAST TRACK  PE 12	Eurojersey	CE 12
FELIX	Corti	CV
FELT	Fir spa	CV
FELTISH  LIGHT	Taborelli	CI 11/12
FELTISH  REPS	Taborelli	CI 11/12
FELTISH SEMPLICE	Taborelli	CI 11/12
FELTISH TELA	Taborelli	CSP
FELTJAM	Fir spa	CV
FELTONE LANA BRISE' DIS STEEL OPACO	Lanificio di soci	CSP
FELTONE LANA BRISE' OPACO	Lanificio di soci	CSP
FELTUS	Fir spa	CV
FELTUS + DENIM+ IDRO	Lanificio di soci	CSP
FELTUS ACC LIGHT	Lanificio di soci	CI 10/11
FELTUS ACC LIGHT + idro	Lanificio di soci	CSP
FELTUS ACC PIZZO REPS	Lanificio di soci	CSP
FELTUS ACC REPS	Lanificio di soci	CI 10/11
FELTUS ACC REPS + idro	Lanificio di soci	CSP
FELTUS CRINKLE ACC LIGHT	Lanificio di soci	CI 10/11
FELTUS CRINKLE IN SEMPLICE	Lanificio di soci	CI 10/11
FELTUS IN SEMPLICE	Lanificio di soci	CI 10/11
FELTUS LANA BRISE' DIS STEEL LUCIDO	Lanificio di soci	CSP
FELTUS LANA BRISE' LUCIDO	Lanificio di soci	CSP
FELTUS LIGHT BEROFIN	Lanificio di soci	CSP
FELTUS SEMPLICE + IDRO	Lanificio di soci	CSP
FELTUS SOLO STAMPATO	Lanificio di soci	CSP
FELTY ACC. LIGHT	Sanesi	CV
FELTY REPS	Sanesi	CV
FELTY RESINATO	Sanesi	CV
FELTY SEMPLICE	Sanesi	CV
FELTY SOFT	Sanesi	CV
FENDI	Riedel Textil	CSP
FIORE SPAGNOLO LIGHT	Lange	CV
FIORE SPAGNOLO RESINATO	Lange	CV
FIORE SPAGNOLO SEMPLICE	Lange	CV
FIORE SPAGNOLO TELA	Lange	CV
FIRE	My Way	CV
FLAGANAWA ACC. LIGHT	Lange	CV
FLAGANAWA ACC. TELA	Lange	CV
FLAGANAWA IN SEMPLICE	Lange	CV
FLAMENGO ACC. LIGHT	Taborelli	CV
FLAMENGO ACC. REPS	Taborelli	CV
FLAMENGO IN SEMPLICE	Taborelli	CV
FLIGHTER ACC  LIGHT	Frigerio	
FLIGHTER ACC REPS	Frigerio	
FLIGHTER DENIM + IDRO	Frigerio	CSP
FLIGHTER IN SEMPLICE	Frigerio	CE 11
FLIP	Lange	CV
FLOWER BAY ACC. LIGHT	Lange	CV
FLOWER BAY ACC.TELA	Lange	CV
FLOWER BAY IN SEMPLICE	Lange	CV
FLOWER SILK	Taborelli	CV
FLOYD	Lange	CV
FLUID	Yong Tong	CV
FLY	Cifra	CV
FOD. BRICS TINTA DA BECCALLI RESINATA	Taborelli	CSP
FOD. ESCADA LAV. SUPERFLYER	Frigerio	CSP
FOD. FERRAGAMO RESINATA + IDRO  + CARA BIS	Taborelli	CSP
FOD. GOLD CHROME HEART RESINATA	Taborelli	CSP
FOD. GOLD MARKIARO RESINATA	Taborelli	CSP
FOD. JACQUARD ADPEL  TABORELLI	Taborelli	CSP
FOD.BRICS TINTA DA TINTEA RESINATA	Taborelli	CSP
FOD.ESCADA SPECCHIO TRASPARENTE	Frigerio	CSP
FODERA  JACUCCI RESINATA	Lange	CSP
FODERA BRICS MARRONE RES.IDRO	Taborelli	CSP
FODERA BRICS NERA RESINATA	Taborelli	
FODERA COTONE  H ACC TELA	Taborelli	CSP
FODERA COTONE  H RESINATA	Taborelli	CSP
FODERA COTONE A ACC TELA	Taborelli	CSP
FODERA COTONE A RESINATA	Taborelli	CSP
FODERA COTONE B ACC TELA	Taborelli	CSP
FODERA COTONE B RESINATA	Taborelli	CSP
FODERA COTONE C ACC TELA	Taborelli	CSP
FODERA COTONE C RESINATA	Taborelli	CSP
FODERA COTONE D ACC TELA	Taborelli	CSP
FODERA COTONE D RESINATA	Taborelli	CSP
FODERA COTONE E ACC TELA	Taborelli	CSP
FODERA COTONE E RESINATA	Taborelli	CSP
FODERA COTONE F ACC TELA	Taborelli	CSP
FODERA COTONE F RESINATA	Taborelli	CSP
FODERA COTONE G ACC TELA	Taborelli	CSP
FODERA COTONE G RESINATA	Taborelli	CSP
FODERA COTONE I ACC TELA	Taborelli	CSP
FODERA COTONE I RESINATA	Taborelli	CSP
FODERA COTONE L ACC TELA	Frigerio	CSP
FODERA COTONE L RESINATA	Frigerio	CSP
FODERA ESCADA FRIGERIO RESINATA	Frigerio	CSP
FODERA ESCADA RESINATA	Frigerio	CSP
FODERA FERRAGAMO RESIN.+ IDRO  + CARA	Taborelli	CSP
FODERA FERRAGAMO RESINATA + IDRO	Taborelli	CSP
FODERA FRIGERIO ART. 10	Frigerio	CV
FODERA FRIGERIO ART. 11	Frigerio	CV
FODERA FRIGERIO ART. 14	Frigerio	CV
FODERA FRIGERIO ART. 15	Frigerio	CV
FODERA FRIGERIO ART. 16	Frigerio	CV
FODERA FRIGERIO ART. 20	Frigerio	CV
FODERA FRIGERIO ART. 21	Frigerio	CV
FODERA FRIGERIO ART. 22	Frigerio	CV
FODERA FRIGERIO ART. 23	Frigerio	CV
FODERA FRIGERIO ART. 25	Frigerio	CV
FODERA FRIGERIO ART. 26	Frigerio	CV
FODERA FRIGERIO ART. 4/5	Frigerio	CV
FODERA FRIGERIO ART. 8	Frigerio	CV
FODERA FRIGERIO ART.2/3/6/9/12	Frigerio	CV
FODERA FRIGERIO ART.7	Frigerio	CV
FODERA GEOX NUOVA + BEROFIN	Frigerio	CSP
FODERA MARINE ESCADA RESINATO	Taborelli	CSP
FODERA PRADA RESINATA EXPERT	My Way	
FODERE FRIGERIO  ART.  1	Frigerio	CV
FODERE FRIGERIO ART. 24	Frigerio	CV
FOSTER	Heat Coat	CV
FRANKY	My Way	CV
FREE SOUL  ACC. REPS	Beccalli	CV
FREELAND REPS	Ambiente Uomo	CV
FREELAND RESINATO	Ambiente Uomo	CV
FREELAND SEMPLICE	Ambiente Uomo	CV
FREELAND SOFT	Ambiente Uomo	CV
FREELIFE	Piave	CV
FREESTYLE	Corti	CV
FREEWAY	Corti	CV
FROISSE' ACC. LIGHT	Namsan Technology	CV
FROISSE' ACC. REPS	Namsan Technology	CV
FROISSE' ACC. TELA	Namsan Technology	CV
FROISSE' IN SEMPLICE	Namsan Technology	CV
FUBUK	Lange	CV
FULL METAL ACC. LIGHT	Lange	CV
FULL METAL ACC. TELA	Lange	CV
FULL METAL IN SEMPLICE	Lange	CV
FULL WASHED ACC. LIGHT	Lange	CV
FULL WASHED ACC. TELA	Lange	CV
FULL WASHED IN SEMPLICE	Lange	CV
FUNK REPS	Gif	CV
FUNK SEMPLICE	Gif	CV
FUNK SOFT	Gif	CV
FUNK SPALMATO	Gif	CV
FUNKY ACC LIGHT	Beccalli	CV
FUNKY ACC REPS	Beccalli	CV
FUNKY IN SEMPLICE	Beccalli	CV
FUSION BIANCO	Erco Pizzi	CV
FUSION NERO	Erco Pizzi	CV
FUSTAGNO LANCEL ACC. REPS	Bossi	CSP
FUSTAGNO LANCEL ACC.LIGHT	Bossi	CSP
FUSTAGNO LANCEL IN SEMPLICE	Bossi	CSP
FYGI	Ambiente Uomo	CV
FYJI	Ambiente Uomo	CV
GALAPAGOS VAR 5 - 6	Lange	
GALAPAGOS VAR DA 1 A 4	Lange	CE 10
GAMISH	Lange	CV
GARDEN ACC. TELA	Furlana	CCL
GARDEN IN SEMPLICE	Furlana	CCL
GARFIELD	Corti	CV
GARRIS	Gif	CV
GARY COL.NERO	Corti	CV
GARY COLORATO	Corti	CV
GAYLE ACC. LIGHT	Taborelli	CV
GAYLE ACC. REPS	Taborelli	CV
GAYLE IN SEMPLICE	Taborelli	CV
GEKO	Sat idea	CV
GIBSON LIGHT	Corti	CCL
GIBSON RESINATO	Corti	CCL
GIBSON SEMPLICE	Corti	CCL
GIBSON TELA	Corti	CCL
GIFT	Frigerio	CV
GIPSY ACC. REPS	Mariani cinese	CV
GIPSY ACC. STRETCH	Mariani cinese	CV
GIPSY IN SEMPLICE	Mariani cinese	CV
GIPSY SOFT	Mariani cinese	CV
GLAM DENNIS	Lange	CI 10/11
GLAMOUR ACC. DENIM NERO	Antares	CV
GLAMOUR ACC. LYCRA NERO	Antares	CV
GLAMOUR IN SEMPLICE	Antares	CV
GLAMOUR METAL AC. DENIM NERO	Antares	CV
GLAMOUR METAL ACC. LYCRA NERO	Antares	CV
GLAMOUR METAL IN SEMPLICE	Antares	CV
GLIDE	Toia	CV
GLITTCOLOR BASE LYCRA BIANCA	Piave	CV
GLITTCOLOR DENIM BIANCO	Piave	CV
GLITTCOLOR DENIM NERO	Piave	CV
GLITTCOLOR DENIM WALLY COLORATO	Piave	CV
GLITTCOLOR LYCRA NERA	Piave	CV
GLITTCOLOR LYCRA WALLY COLORATO	Piave	CV
GLITTER	Lange	CV
GLITTER FIVE	Namsan Technology	CCL
GLOBAL	Heat Coat	CV
GLOVE BOUCLE'	Griffine	CCL
GLOVE GARDEN	Griffine	CV
GLOVE PYTON SEMPLICE	Griffine	CV
GLOVE PYTON STRETCH	Griffine	CV
GLOVE SCUBA	Griffine	CSP
GLOVE STRETCH IN SEMPLICE	Griffine	CCL
GLOVE STRETCH LOFT	Griffine	CCL
GLOVE STRETCH TELA	Griffine	CCL
GOA LIGHT	Taborelli	CV
GOA SEMPLICE	Taborelli	CV
GOA TELA	Taborelli	CV
GOGO	Lange	CV
GOLD BAY ACC. LIGHT	Lange	CV
GOLD BAY ACC. LIGHT+IDRO BEROFIN CELINE	Lange	CV
GOLD BAY ACC. TELA	Lange	CV
GOLD BAY IN SEMPLICE	Lange	CV
GOLD CHAIN  ACC LIGHT	Tat	CI 10/11
GOLD CHAIN  ACC REPS	Tat	CI 10/11
GOLD CHAIN  in semplice	Tat	CI 10/11
GOLD CHAIN ART 76 IN SEMPLICE	Tat	CI 10/11
GOLD COITTON ACC. LIGHT	Lange	CV
GOLD COTTON ACC. TELA	Lange	CV
GOLD COTTON IN SEMPLICE	Lange	CV
GOLD DENIM IN SEMPLICE	Gif	CV
GOLD DIAMOND LIGHT	Beccalli	CI 11/12
GOLD DIAMOND REPS	Beccalli	CI 11/12
GOLD DIAMOND SEMPLICE	Beccalli	CI 11/12
GOLD ISLAND ACC. LIGHT COLORATI	Lange	CV
GOLD ISLAND ACC. LIGHT ORO/ARGENTO	Lange	CV
GOLD ISLAND ACC. TELA COLORATI	Lange	CV
GOLD ISLAND ACC. TELA ORO/ARGENTO	Lange	CV
GOLD ISLAND IN SEMPLICE COLORATI	Lange	CV
GOLD ISLAND IN SEMPLICE ORO/ARGENTO	Lange	CV
GOLD JAM IN SEMPLICE	Lange	CV
GOLD LINUS ACC LIGHT	Frigerio	CE 11
GOLD LINUS ACC REPS	Frigerio	CE 11
GOLD LINUS IN SEMPLICE	Frigerio	CE 11
GOLD NATURAL ACC. LIGHT	Lange	CV
GOLD NATURAL ACC. TELA	Lange	CV
GOLD NATURAL IN SEMPLICE	Lange	CV
GOLD NEOPREN	Carvico	
GOLD SAND  ACC LIGHT	Lange	CE 11
GOLD SAND  IN SEMPLICE	Lange	CE 11
GOLD SAND ACC TELA	Lange	CE 11
GOLD SAND VAR 1-2-3 ACC LIGHT	Lange	CE 11
GOLD SAND VAR 1-2-3 ACC TELA	Lange	CE 11
GOLD SAND VAR 1-2-3 IN SEMPLICE	Lange	CE 11
GOLD STRETCH LIGHT	Taborelli	CI 11/12
GOLD STRETCH LYCRA	Taborelli	
GOLD STRETCH REPS	Taborelli	CI 11/12
GOLD STRETCH SEMPLICE	Taborelli	CI 11/12
GOLD SUN ACC. LIGHT	Lange	CV
GOLD SUN ACC. TELA	Lange	CV
GOLD SUN IN SEMPLICE	Lange	CV
GOLD WEST ACC. TELA ORO/ARGENTO	My Way	CV
GOLD WEST COLORATO ACC. TELA	My Way	CV
GOLD WOOL IN SEMPLICE	Taborelli	CI 11/12
GOLD WOOL LIGHT+IDRO	Taborelli	CI 11/12
GOLD WOOL REPS+IDRO	Taborelli	CI 11/12
GOLDEN MOON solo in semplice	Taborelli	CE 10
GOLDFINGER ACC LIGHT	Tat	CE 10
GOLDFINGER ACC TELA	Tat	CE 10
GOLDFINGER IN SEMPLICE	Tat	CE 10
GOLDFIRE ACC LIGHT	Taborelli	CI09/10
GOLDFIRE ACC REPS	Taborelli	CI09/10
GOLDFIRE IN SEMPLICE	Taborelli	CI09/10
GOLDFLY ACC LIGHT	Frigerio	CE 11
GOLDFLY ACC REPS	Frigerio	CE 11
GOLDFLY IN SEMPLICE	Frigerio	CE 11
GOMMATO 3 OSKLEN BIS	Barzaghi	
GOMMATO 3 OSKLEN NO IDRO	Barzaghi	
GOMMATO OSKEN 3 BIS PIU' IDRO	Barzaghi	
GOMMATO OSKEN 3 PIU' IDRO	Barzaghi	
GONZO	Corti	CV
GOSPEL	Taborelli	CV
GOTAN BEACH ACC LIGHT	Lange	CE 10
GOTAN BEACH ACC TELA	Lange	CE 10
GOTAN BEACH IN SEMPLICE	Lange	CE 10
GOTAN DENIM	Eurojersey	CV
GOTAN LYCRA	Eurojersey	CV
GOTAN STRETCH	Eurojersey	CV
GRACE BAY ACC LIGHT	My Way	CE 11
GRACE BAY ACC REPS	My Way	
GRACE BAY CRINKLE	My Way	CE 11
GRACE BAY CRINKLE LIGHT	My Way	CE 11
GRACE BAY IN NATURA RESINATO	My Way	
GRACE BAY IN SEMPLICE	My Way	
GRACE BAY RESINATO	My Way	CSP
GRAFFYS ACC LIGHT	My Way	CCL
GRAFFYS ACC TELA	My Way	CCL
GRAFFYS IN SEMPLICE	My Way	CCL
GRANT	Griffine	CV
GRAY STRETCH	Raion Inveruno	CV
GRIFFIN	Piave	CV
GRISAGLIA FLOWER  LUREX ACC. REPS + LAME'	Taborelli	CV
GRISAGLIA FLOWER ACC. LIGHT	Taborelli	CV
GRISAGLIA FLOWER ACC. REPS	Taborelli	CV
GRISAGLIA FLOWER IN SEMPLICE	Taborelli	CV
GRISAGLIA FLOWER LUREX ACC. LIGHT LAME'	Taborelli	CV
GRISAGLIA FLOWER LUREX IN SEMPLICE LAME'	Taborelli	CV
GRO MARINE ACC. LIGHT	Frigerio	CV
GRO MARINE ACC. TELA	Frigerio	CV
GRO MARINE IN SEMPLICE	Frigerio	CV
GRO POIS LIGHT	Beccalli	CV
GRO POIS REPS	Beccalli	CV
GRO POULE ACC. LIGHT	Beccalli	CV
GRO POULE ACC. REPS	Beccalli	CV
GRO POULE IN SEMPLICE	Beccalli	CV
GRO STEEL ACC. LIGHT	Magitex	CCL
GRO STEEL ACC. TELA	Magitex	CCL
GRO STEEL IN SEMPLICE	Magitex	CCL
GRO VICHY ACC. LIGHT	Beccalli	CV
GRO VICHY ACC. REPS	Beccalli	CV
GRO VICHY IN SEMPLICE	Beccalli	CV
GROS GRAIN ACC. LIGHT	Arnetta	CCL
GROS GRAIN ACC. TELA	Arnetta	CCL
GROS GRAIN IN SEMPLICE	Arnetta	CCL
GROS GRAIN LAME'  ACC. TELA	Magitex	CV
GROS GRAIN REPS	Tesmo	CCL
GROS GRAIN RESINATO	Magitex	CCL
GROS GRAIN STAMPATO ESCADA	Tesmo	CV
GROS GRAIN STAMPATO ESCADA RESINATO	Tesmo	CV
GROS GRAIN STAMPATO ESCADA SOFT	Tesmo	CV
GROS GRAIN STAMPATO ESCADA TELA	Tesmo	CV
GROS STEEL RESINATO	Magitex	CCL
GRUNCE ACC. REPS VAR. 5/6/7/8	Taborelli	CV
GRUNGE ACC. LIGHT VAR.1/2/3/4	Taborelli	CV
GRUNGE ACC. LIGHT VAR.5/6/7/8	Taborelli	CV
GRUNGE ACC.REPS VAR.1/2/3/4	Taborelli	CV
GRUNGE IN SEMPLICE VAR.1/2/3/4	Taborelli	CV
GRUNGE IN SEMPLICE VAR.5/6/7/8	Taborelli	CV
GUADALUPE	Lange	CE 10
GUADALUPE SENZA STROPICCIO JOSPEH SEIBEL	Lange	
GUCCI FODERA NYLON IN SEMPLICE	Frigerio	CSP
GUCCI FODERA NYLON RESINA +DIR.FILO	Frigerio	CSP
GUGHY	Piave	CV
GUN METAL ACC. LIGHT	My Way	CV
GUN METAL ACC. TELA	My Way	CV
GUN METAL IN SEMPLICE	My Way	CV
GUNNY	Piave	CV
GUYAN	Lange	CV
GWEN ACC. LIGHT	Ambiente Uomo	CV
GWEN ACC. REPS	Ambiente Uomo	CV
GWEN IN SEMPLICE	Ambiente Uomo	CV
HAKIM	Taborelli	CV
HAMIL ACC. LIGHT	Taborelli	CV
HAMIL ACC. REPS	Taborelli	CV
HAMIL IN SEMPLICE	Taborelli	CV
HANCOCK ACC. SOFT VAR 2/4/5	Forma	CV
HANCOCK ACC. SOFT VAR.3	Forma	CV
HANCOCK SOFT  VAR.1	Forma	CV
HAPPY FLOWER	Lange	CV
HAREM BIANCO	Lange	CCL
HAREM BIANCO IN SEMPLICE	Lange	CCL
HAREM COLORATO	Lange	CCL
HAREM COLORATO IN SEMPLICE	Lange	CCL
HAREM NERO	Lange	CCL
HAREM NERO IN SEMPLICE	Lange	CCL
HARLEM	Gif	CV
HARPER/MASON SEMPLICE	Mizar	CV
HARPER/MASON SOFT	Mizar	CV
HARPER/MASON TELA	Mizar	CV
HARRYS	Griffine	CV
HARUKY DENIM	Eurojersey	CV
HARUKY LYCRA	Eurojersey	CV
HARUKY SEMPLICE	Eurojersey	CV
HARUKY SPALMATO	Eurojersey	CV
HAVANA	Erco Pizzi	CV
HAWAII  ACC. LIGHT	Lange	CV
HAWAII  ACC. TELA	Lange	CV
HAWAII IN SEMPLICE	Lange	CV
HEALING	My Way	CV
HERBY	Aresia	CV
HERRY	Yong Tong	CV
HILL	Toia	CV
HINDU LIGHT	Corti	CV
HINDU RESINATO	Corti	CV
HINDU SEMPLICE	Corti	CV
HINDU TELA	Corti	CV
HINES RESINATO	Lange	CV
HINES SEMPLICE	Lange	CV
HINES SOFT	Lange	CV
HINES TELA	Lange	CV
HIP HOP ACC LIGHT	Beccalli	CV
HIP HOP ACC REPS	Beccalli	CV
HIP HOP IN SEMPLICE	Beccalli	CV
HIPPY	Lange	CV
HIROSHI LIGHT	Namsan Technology	CV
HIROSHI REPS	Namsan Technology	CV
HIROSHI SEMPLICE	Namsan Technology	CV
HONEY ACC LIGHT	My Way	CCL
HONEY ACC TELA	My Way	CCL
HONEY IN SEMPLICE	My Way	CCL
HONEY REPS - VECCHIO	Corti	CCL
HONEY RESINATO - VECCHIO	Corti	CCL
HONEY SEMPLICEB - VECCHIO	Corti	CCL
HONEY SOFT - VECCHIO	Corti	CCL
HOOKER DENIM+IDRO	Corti	CSP
HOOKER LIGHT PE 12	Corti	CE 12
HOOKER REPS PE 12	Corti	
HOOKER SEMPLICE PE 12	Corti	CE 12
HOOP	Lange	CV
HORACE  REPS	Forma	CV
HORACE RESINATO	Forma	CV
HORACE SEMPLICE	Forma	CV
HORACE SOFT	Forma	CV
HORNET  ACC LIGHT	Corti	CI 10/11
HORNET  ACC REPS	Corti	CI 10/11
HORNET  IN SEMPLICE	Corti	CI 10/11
HORNET + DENIM + IDRO	Corti	CSP
HOT AFRICA ACC. REPS	Lange	CV
HOT AFRICA GREGGIO TELA	Lange	CV
HOT AFRICA GREGIO LIGHT	Lange	CV
HOT AFRICA LIGHT	Lange	CV
HOT AFRICA TELA	Lange	CV
HOT BLACK	Tat	CV
HOT DESERT LIGHT	Forma	CE 12
HOT DESERT RESINATO	Forma	CSP
HOT DESERT SEMPLICE	Forma	CE 12
HOT DESERT TELA	Forma	CE 12
HOT FLOWER LIGHT	Ricamificio 2G	CE 12
HOT FLOWER SEMPLICE	Ricamificio 2G	CE 12
HOT FLOWER TELA	Ricamificio 2G	CE 12
HOT GLITT LAMINA COLORATA ACC. LIGHT	My Way	CV
HOT GLITT LAMINA COLORATA ACC. TELA	My Way	CV
HOT GLITT LAMINA ORO/ARGENTO ACC. LIGHT	My Way	CV
HOT GLITT LAMINA ORO/ARGENTO ACC. TELA	My Way	CV
HOT SAND LIGHT	Forma	CE 12
HOT SAND RESINATO	Forma	CSP
HOT SAND SEMPLICE	Forma	CE 12
HOT SAND TELA	Forma	CE 12
HOT SEA LIGHT	Forma	CE 12
HOT SEA SEMPLICE	Forma	CE 12
HOT SEA TELA	Forma	CE 12
HOT SKY LIGHT PE 12	Ricamificio 2G	CE 12
HOT SKY SEMPLICE PE 12	Ricamificio 2G	CE 12
HOT SKY TELA PE 12	Ricamificio 2G	CE 12
HOT STONE CRINKLE	Lange	CE 12
HOT STONE LIGHT	Lange	CE 12
HOT STONE SEMPLICE	Lange	CE 12
HOT STONE TELA	Lange	CE 12
HOT STONE VAR 1 SECRET B.CO CRINKLE	Lange	CE 12
HOT STONE VAR 1 SECRET B.CO light	Lange	CE 12
HOT STONE VAR 1 SECRET B.CO SEMPLICE	Lange	
HOT STONE VAR 1 SECRET B.CO TELA	Lange	CE 12
HOT STONE VECCHIO ACC REPS	Taborelli	CE 10
HOT STONE VECCHIO IN SEMPLICE	Taborelli	CE 10
HOT STONE VECCHIOACC LIGHT	Taborelli	CE 10
HOT WHITE	Frigerio	CV
HOT WIND VAR 1 - 2 ACC LIGHT	My Way	CE 10
HOT WIND VAR 1 - 2 ACC TELA	My Way	
HOT WIND VAR 1 - 2 CRINKLE	My Way	
HOT WIND VAR 1 - 2 CRINKLE LIGHT	My Way	
HOT WIND VAR 1 - 2 IN SEMPLICE	My Way	CE 10
HOT WIND VAR 3 - 4 ACC LIGHT	Lange	CE 10
HOT WIND VAR 3 - 4 ACC TELA	Lange	CE 10
HOT WIND VAR 3 - 4 CRINKLE	Lange	CE 10
HOT WIND VAR 3 - 4 CRINKLE LIGHT	Lange	CE 10
HOT WIND VAR 3 - 4 IN SEMPLICE	Lange	CE 10
HUNTER ACC. LIGHT	Sat idea	CV
HUNTER ACC. REPS	Sat idea	CV
HUNTER IN SEMPLICE	Sat idea	CV
ICE METAL ACC LIGHT COLORATI	My Way	CV
ICE METAL ACC LIGHT ORO/ARG.	My Way	CV
ICE METAL ACC TELA COLORATI	My Way	CV
ICE METAL ACC TELA ORO/ARG	My Way	CV
ICE METAL IN SEMPLICE COLORATO	My Way	CV
ICEBERG	Corti	CV
IKE	Carvico	CV
IKON	Uco	CV
INDIAN 2 REPS	Ambiente Uomo	CV
INDIAN 2 RESINATO	Ambiente Uomo	CV
INDIAN 2 SEMPLICE	Ambiente Uomo	CV
INDIAN 2 SOFT	Ambiente Uomo	CV
INDIAN REPS	Ambiente Uomo	CV
INDIAN SEMPLICE	Ambiente Uomo	CV
INDIAN SOFT	Ambiente Uomo	CV
INDIGO ACC. LIGHT	Taborelli	CCL
INDIGO ACC. REPS	Taborelli	CCL
INDIGO ACC. TELA	Taborelli	CCL
INDIGO IN SEMPLICE	Taborelli	CCL
INDY	Corti	CV
INTRECCIO 1/4 BURBERRY RESINATO	Lange	CV
INTRECCIO 1/4 BURBERRY SEMPLICE	Lange	CV
INTRECCIO 1/4 BURBERRY SOFT	Lange	CV
INTRECCIO 1/4 BURBERRY TELA	Lange	CV
INTRECCIO 2 BURBERRY RESINATO	Lange	CV
INTRECCIO 2 BURBERRY SEMPLICE	Lange	CV
INTRECCIO 2 BURBERRY SOFT	Lange	CV
INTRECCIO 2 BURBERRY TELA	Lange	CV
INTRECCIO 3 BURBERRY RESINATO	Lange	CV
INTRECCIO 3 BURBERRY SEMPLICE	Lange	CV
INTRECCIO 3 BURBERRY SOFT	Lange	CV
INTRECCIO 3 BURBERRY TELA	Lange	CV
INTRECCIO BURBERRY RESINATO	Lange	CV
INTRECCIO BURBERRY SEMPLICE	Lange	CV
INTRECCIO BURBERRY SOFT	Lange	CV
INTRECCIO BURBERRY TELA	Lange	CV
IRISH ACC. LIGHT+idro	Bossi	CCL
IRISH ACC. REPS	Bossi	CCL
IRISH ACC. REPS idro BEROFIN	Bossi	CCL
IRISH GLASS ACC. LIGHT	Bossi	CCL
IRISH GLASS ACC. REPS	Bossi	CCL
IRISH GLASS IN SEMPLICE	Bossi	CCL
IRISH IN SEMPLICE	Bossi	CCL
IRISH RESINATO	Bossi	CCL
IRONY + JAMISON COLORATI	Piave	CSP
IRONY + JAMISON ORO ARGENTO	Piave	CSP
IRONY ACC. LIGHT	Griffine	CCL
IRONY BASKET ACC LOFT	Griffine	CCL
IRONY BASKET ACC. LIGHT	Griffine	CCL
IRONY BASKET IN SEMPLICE	Griffine	CCL
IRONY LOFT	Griffine	CCL
IRONY SEMPLICE	Griffine	CCL
IRONY SOFT	Griffine	CCL
IRONY TELA	Griffine	CCL
IRVING	Corti	CV
IVERSON ACC. LIGHT	Corti	CCL
IVERSON ACC. REPS	Corti	CCL
IVERSON IN SEMPLICE	Corti	CCL
IVORY	Ambiente Uomo	CV
"J. JORDAN ""GG"" ACC.INTERL.BIANCO IDRO"	Frigerio	CSP
"J. JORDAN ""GG"" ACC.INTERL.NERO IDRO"	Frigerio	CSP
"J. JORDAN ""GG"" ACC.PANAMA GARZ. IDRO"	Frigerio	CSP
"J. JORDAN ""GG"" RESINA  IDRO"	Frigerio	CSP
JA		
JABBY	Cifra	CV
JACKSON FIN. TRANC COAT SEMPLICE	Lange	CV
JACKSON FIN. TRANC COAT TELA	Lange	CV
JACKSON RESINATO	Lange	CV
JACKSON SEMPLICE	Lange	CV
JACKSON SOFT	Lange	CV
JACKSON TELA	Lange	CV
JACOB IN SEMPLICE	Tex Fation	CV
JACOB SOFT	Tex Fation	CV
JACOB SPALMATO	Tex Fation	CV
JACOB TELA	Tex Fation	CV
JACQ GUCCI LAV.ACC.PANAMA GARZ+IDRO	Frigerio	CSP
JACQ GUCCI LAV.ACC.PANAMA GARZ+IDRO BIANCO	Frigerio	CSP
JACQ GUCCI LAV.ACC.PANAMA GARZ+IDRO NERO	Frigerio	CSP
JACQ JORDAN GUCCI LAV.+IDRO+RES.+DIR.FIL	Frigerio	CSP
JACQ JORDAN GUCCI LAVATO	Frigerio	CSP
JACQ PEQUIN LUREX ORO CHIARO/COLORATI LIGHT + IDRO	Frigerio	
JACQ. BARBADOS ACC LIGHT	Frigerio	CCL
JACQ. BARBADOS ACC TELA	Frigerio	CCL
JACQ. BARBADOS IN SEMPLICE	Frigerio	CCL
JACQ. GRUNGE CELIN FUL L WASHED PL/COT	Taborelli	CV
JACQ. GUCCI PETTINATO AMERICA + PAN.COL.CHIARI +ID	Frigerio	
JACQ. GUCCI PETTINATO AMERICA + PANAMA GARZATO+ ID	Frigerio	
JACQ. GUCCI PETTINATO AMERICA + PANAMA NERO+IDRO.	Frigerio	
JACQ. GUCCI PETTINTO AMERICA + PANAMA BIANCO+ IDRO	Frigerio	
JACQ. ISLAND ACC  TELA	Frigerio	CCL
JACQ. ISLAND ACC LIGHT	Frigerio	CCL
JACQ. ISLAND IN SEMPLICE	Frigerio	CCL
JACQ. JORDAN GEOX LANCE TELA GASATO	Frigerio	CSP
JACQ. JORDAN GEOX TELA GASATO NORMALE	Frigerio	CSP
JACQ. RASO METALLO  SEMPLICE	Frigerio	CSP
JACQ. SUITE ACC. LIGHT	Frigerio	CCL
JACQ. SUITE ACC. LIGHT + IDRO	Frigerio	CSP
JACQ. SUITE ACC. REPS	Frigerio	CCL
JACQ. SUITE ACC. TELA	Frigerio	CCL
JACQ. SUITE ACC. TELA BEROFIN	Frigerio	CCL
JACQ. SUITE IN SEMPLICE + IDRO	Frigerio	CCL
JACQ.BULGARI ACC. DENIM + IDRO	Taborelli	CSP
JACQ.BULGARI ACC. TELA + IDRO	Taborelli	CSP
JACQ.BURBERRY  POLIES./COT.ACC.DENIM + IDRO	Frigerio	CSP
JACQ.BURBERRY POLIES/COT.IN SEMPLICE + IDRO	Frigerio	CSP
JACQ.BURBERRY POLIEST/COT.IN SEMPLICE + IDRO	Frigerio	CSP
JACQ.DENIM DOP.TRAMA  ZUCCA+CIM+CES.ENZ.- SEMP	Frigerio	
JACQ.DENIM DOPPIA TRAMA DIS. ZUCCA VECCHIA - SEMP	Frigerio	
JACQ.DENIM DOPPIA TRAMA DIS.ZUCCA+CIM.VERT.DENIM	Frigerio	
JACQ.DENIM DOPPIA TRAMA DIS.ZUCCA+CIM.VERT.LIGHT	Frigerio	
JACQ.DENIM DOPPIA TRAMA DIS.ZUCCA+CIM.VERT.RESIN.	Frigerio	
JACQ.GRUNGE CELINE FULL WASHED COT.	Taborelli	CSP
JACQ.JORDAN ECON. MEDITERRANEA ACC. TELA + ID	Frigerio	CSP
JACQ.JORDAN ECON.MEDITERRANEA ACC. LIGHT + IDRO	Frigerio	CSP
JACQ.JORDAN GUCCI LAV.+IDRO+RES+DIR.FILO	Frigerio	
JACQ.JORDAN TIMBERLAND ACC.TELA BEROFIN	Frigerio	CSP
JACQ.JORDAN TIMBERLAND IN SEMP.+IDRO	Frigerio	CSP
JACQ.LUREX BULGARI  ACC.LIGHT+IDRO	Taborelli	CSP
JACQ.LUREX BULGARI CAMP.3 ACC.LIGHT+IDRO	Taborelli	CSP
JACQ.LUREX BULGARI CAMP.3 IN SEMP.+ IDRO	Taborelli	CSP
JACQ.LUREX BULGARI IN SEMP.+ IDRO	Taborelli	CSP
JACQ.PENGUIN ACC LIGHT	Frigerio	CCL
JACQ.PENGUIN ACC TELA	Frigerio	CCL
JACQ.PENGUIN IN SEMPLICE	Frigerio	CCL
JACQ.SUITE ACC. REPS  BEROFIN	Frigerio	CCL
JACQ.SUITE IN SEMPLICE VAR. 7/8/9/10	Frigerio	CCL
JACQUARD  DENIM LUREX ACC.REPS	Taborelli	CSP
JACQUARD  GLAM ACC LIGHT	Frigerio	CV
JACQUARD  GLAM ACC TELA	Frigerio	CV
JACQUARD  GLAM IN SEMPLICE	Frigerio	CV
JACQUARD  MARINE RESINATO	Taborelli	CCL
JACQUARD  NG  ECO IN SEMPLICE	Taborelli	CSP
JACQUARD B  METAL NANNINI ACC.TELA	Taborelli	CSP
JACQUARD B METAL NANNINI ACC. LIGHT	Taborelli	CSP
JACQUARD B NANNINI ACC. TELA	Taborelli	CSP
JACQUARD B NANNINI ACC.LIGHT	Taborelli	CSP
JACQUARD BALI  NANNINI  ACC. LIGHT + IDRO	Taborelli	CSP
JACQUARD BALI NANNINI  ACC. LIGHT	Taborelli	CSP
JACQUARD BALI NANNINI  EUROFINISS ACC. LIGHT +IDRO	Taborelli	CSP
JACQUARD BALI NANNINI ACC. TELA	Taborelli	CSP
JACQUARD BALI NANNINI ACC. TELA + IDRO	Taborelli	CSP
JACQUARD BALLY  RESINATO + IDRO FONDO RASO	Taborelli	CSP
JACQUARD BALLY FONDO TELA 45 INSERZIONI	Taborelli	CSP
JACQUARD BALLY LOGO F.DO TELA 45 INSERZIONI	Taborelli	CSP
JACQUARD BALLY LOGO RESINATO + IDRO	Taborelli	CSP
JACQUARD BASKET	Frigerio	CV
JACQUARD BIRKIN   ACC. TELA BEROFIN	Frigerio	CCL
JACQUARD BIRKIN AC. REPS BEROFIN	Frigerio	CCL
JACQUARD BIRKIN ACC. DENIM	Frigerio	CCL
JACQUARD BIRKIN ACC. LIGHT	Frigerio	CCL
JACQUARD BIRKIN ACC. LIGHT + IDRO +  4,00 IN +	Frigerio	CSP
JACQUARD BIRKIN ACC. LIGHT BEROFIN	Frigerio	CCL
JACQUARD BIRKIN ACC. REPS  EXPERT	Frigerio	CCL
JACQUARD BIRKIN ACC. TELA	Frigerio	CCL
JACQUARD BIRKIN ACC.LIGHT + IDRO EUROFINISS	Frigerio	CCL
JACQUARD BIRKIN CELINE ACC. LIGHT + IDRO	Frigerio	CSP
JACQUARD BIRKIN CELINE ACC. TELA + IDRO	Frigerio	CSP
JACQUARD BIRKIN CELINE RESINATO	Frigerio	CSP
JACQUARD BIRKIN DESERT  IN SEMPLICE VAR.1/7	Frigerio	CV
JACQUARD BIRKIN DESERT ACC. TELA VAR.1/7	Frigerio	CV
JACQUARD BIRKIN IN SEMPLICE idro	Frigerio	CCL
JACQUARD BIRKIN IN SEMPLICE NO IDRO	Frigerio	CCL
JACQUARD BIRKIN RESINATO + IDRO	Frigerio	CCL
JACQUARD BIRKIN TRAMA + BELLA LIGHT	Frigerio	CSP
JACQUARD BIRKIN TRAMA+BELLA  LIGHT EUROFINISS	Frigerio	CSP
JACQUARD BIRKIN TRAMA+BELLA IN SEMPLICE	Frigerio	CSP
JACQUARD BIRKIN TRAMA+BELLA LIGHT BEROFIN	Frigerio	CSP
JACQUARD BIRKIN TRAMA+BELLA REPS BEROFIN	Frigerio	CSP
JACQUARD BIRKIN TRAMA+BELLA TELA  BEROFIN	Frigerio	CSP
JACQUARD BRICS nera RESINA+IDRO	Taborelli	CSP
JACQUARD BRITISH ACC REPS BEROFIN	Taborelli	CSP
JACQUARD BRITISH IN SEMPLICE	Taborelli	CSP
JACQUARD BRONZE ACC. LIGTH  COLORATO	Frigerio	CV
JACQUARD BRONZE ACC. TELA  ORO/ARGENTO	Frigerio	CV
JACQUARD BRONZE ACC. TELA COLORATI	Frigerio	CV
JACQUARD BRONZE IN SEMPLICE COLORATI	Frigerio	CV
JACQUARD BRONZE IN SEMPLICE ORO/ARGENTO	Frigerio	CV
JACQUARD BUDDHA GEOX ACC TELA	Frigerio	CSP
JACQUARD BUDDHA GEOX IN SEMPLICE	Frigerio	CSP
JACQUARD BUDDHA OPACO NG COLORATO	Frigerio	CSP
JACQUARD BUDDHA OPACO NG ORO/ARG	Frigerio	CSP
JACQUARD BULGARI LUREX  CAMP.1  ACC.TELA+ IDRO	Taborelli	CSP
JACQUARD BULGARI LUREX CAMP 4 ACC.TELA + IDRO	Taborelli	CSP
JACQUARD BULGARI LUREX CAMP.1 ACC. DENIM + IDRO	Taborelli	CSP
JACQUARD BULGARI LUREX CAMP.2 ACC. DENIM + IDRO	Taborelli	CSP
JACQUARD BULGARI LUREX CAMP.2 ACC. TELA + IDRO	Taborelli	CSP
JACQUARD BULGARI LUREX CAMP.3 ACC. DENIM + IDRO	Taborelli	CSP
JACQUARD BULGARI LUREX CAMP.3 ACC.TELA + IDRO	Taborelli	CSP
JACQUARD BULGARI LUREX CAMP.4 ACC. DENIM + IDRO	Taborelli	CSP
JACQUARD BURBERRY ACC. TELA + IDRO		CSP
JACQUARD C NANNINI ACC. LIGHT	Taborelli	CSP
JACQUARD C NANNINI ACC. TELA	Taborelli	CSP
JACQUARD C NANNINI METAL ACC. LIGHT	Taborelli	CSP
JACQUARD C NANNINI METAL ACC. TELA	Taborelli	CSP
JACQUARD CABRIOLET FENDI ACC LIGHT BEROFIN	Taborelli	CSP
JACQUARD CABRIOLET FENDI ACC REPS BEROFIN	Taborelli	CSP
JACQUARD CABRIOLET FENDI IN SEMPLICE	Taborelli	CSP
JACQUARD CABRIOLET FENDI IN SEMPLICE BEROFIN	Taborelli	CSP
JACQUARD CAMOUFLAGE  FENDI ACC. LIGHT+IDRO BEROFIN	Taborelli	CSP
JACQUARD CAMOUFLAGE DENIM FENDI + IDRO BEROFIN	Taborelli	
JACQUARD CAMOUFLAGE FENDI ACC. REPS + IDRO BEROFIN	Taborelli	CSP
JACQUARD CAMOUFLAGE FENDI IN SEMPLICE	Taborelli	CSP
JACQUARD CAMOUFLAGE FENDI RESINA+D.FILO+IDRO	Taborelli	CSP
JACQUARD CAMOUFLAGE IN SEMPLICE	Taborelli	CI09/10
JACQUARD CAMOUFLAGE LIGHT	Taborelli	CI09/10
JACQUARD CAMOUFLAGE REPS	Taborelli	CI09/10
JACQUARD CANNES ACC REPS BEROFIN	Frigerio	CSP
JACQUARD CANNES IN SEMPLICE	Frigerio	CSP
JACQUARD CANVAS CELINE ACC. DENIM + IDRO	Frigerio	
JACQUARD CANVAS CELINE IN SEMPLICE	Frigerio	
JACQUARD CANVAS CELINE RESIN.+ IDRO + DIR.FILO	Frigerio	
JACQUARD CANVAS LIGHT + IDRO BEROFIN	Frigerio	
JACQUARD CARVELA DOPPIA TRAMA DENIM+IDRO	Frigerio	CSP
JACQUARD CHERRY ACC LIGHT BEROFIN	Frigerio	CSP
JACQUARD CHERRY ACC REPS BEROFIN	Frigerio	CSP
JACQUARD CHERRY IN SEMPLICE	Frigerio	CSP
JACQUARD CHERRY IN SEMPLICE BEROFIN	Frigerio	CSP
JACQUARD CHUNKY CELINE	Frigerio	
JACQUARD CINIGLIA CAVALLI CAMP.C ACC. LIGHT	Frigerio	
JACQUARD CINIGLIA CAVALLI CAMP.C IN SEMPLICE	Frigerio	
JACQUARD CLIVE COTONE/COTONE DA MT 500	Frigerio	CSP
JACQUARD CLIVE NERO TINTO PL/COTONE	Frigerio	CSP
JACQUARD CLIVE NYLON/COTONE	Frigerio	CSP
JACQUARD CLIVE PL/COTONE	Frigerio	CSP
JACQUARD CLUB BREMA RESINA+D.FILO+IDRO BEROFIN	Taborelli	CSP
JACQUARD CLUB BREMA RESINATO EXPERT	Taborelli	
JACQUARD CLUB FENDI	Taborelli	
JACQUARD CLUB RESINA + DIR. FILO + IDRO BEROFIN	Taborelli	
JACQUARD CO/VI MOIRE REPS GREGGIO	Tessile Operati	CV
JACQUARD CO/VI MOIRE REPS TINTO	Tessile Operati	CV
JACQUARD CO/VI MOIRE RESINATO GREGGIO	Tessile Operati	CV
JACQUARD CO/VI MOIRE RESINATO TINTO	Tessile Operati	CV
JACQUARD CO/VI MOIRE SEMPLICE GREGGIO	Tessile Operati	CV
JACQUARD CO/VI MOIRE SEMPLICE TINTO	Tessile Operati	CV
JACQUARD CO/VI MOIRE SOFT GREGGIO	Tessile Operati	CV
JACQUARD CO/VI MOIRE SOFT TINTO	Tessile Operati	CV
JACQUARD COTTON ACC LIGHT	Taborelli	CE 11
JACQUARD COTTON ACC TELA	Taborelli	CE 11
JACQUARD COTTON ESCADA LAME' LIGHT + IDRO	Frigerio	CSP
JACQUARD COTTON ESCADA LIGHT + IDRO	Frigerio	CSP
JACQUARD COTTON GLASS NG SEMPLICE	Taborelli	CSP
JACQUARD COTTON GLASS NG TELA	Taborelli	CSP
JACQUARD COTTON LAME' ACC. TELA	Frigerio	CCL
JACQUARD COTTON LAME' ACC.LIGHT	Frigerio	CCL
JACQUARD COTTON LAME' IN SEMPLICE	Frigerio	CCL
JACQUARD COTTON RESINATO	Taborelli	CE 11
JACQUARD COTTONFRIGERIO  IN SEMPLICE	Frigerio	CV
JACQUARD COTTONFRIGERIO ACC. LIGHT	Frigerio	CV
JACQUARD COTTONFRIGERIO ACC. REPS	Frigerio	CV
JACQUARD COTTONFRIGERIO ACC. TELA	Frigerio	
JACQUARD CROCO	Frigerio	CI09/10
JACQUARD DELUXE 1	Frigerio	CSP
JACQUARD DELUXE 2 SEMPLICE	Frigerio	CSP
JACQUARD DENIM  BIANCO ACC. IDRO	Frigerio	CV
JACQUARD DENIM ACC. LIGHT	Taborelli	CV
JACQUARD DENIM ACC. REPS	Taborelli	CV
JACQUARD DENIM ACC.LIGHT + IDRO	Taborelli	CV
JACQUARD DENIM ACC.REPS BEROFIN	Taborelli	CV
JACQUARD DENIM ACC.TELA	Taborelli	CV
JACQUARD DENIM ACC.TELA BEROFIN	Taborelli	CV
JACQUARD DENIM IN SEMPLICE	Taborelli	CV
JACQUARD DENIM NERO ACC. IDRO	Frigerio	CV
JACQUARD DENIM STRETCH ACC. LIGHT	Taborelli	CV
JACQUARD DENIM STRETCH IN SEMPLICE	Taborelli	CV
JACQUARD DIAMANTE SEMPLICE	Taborelli	CSP
JACQUARD DOUBLE ACC. LIGHT	Frigerio	CV
JACQUARD DOUBLE ACC. TELA	Frigerio	CV
JACQUARD DOUBLE FENDI ACC LIGHT BEROFIN	Frigerio	CSP
JACQUARD DOUBLE FENDI ACC REPS BEROFIN	Frigerio	CSP
JACQUARD DOUBLE FENDI IN SEMPLICE	Frigerio	CSP
JACQUARD DOUBLE FENDI IN SEMPLICE BEROFIN	Frigerio	CSP
JACQUARD DOUBLE IN SEMPLICE	Frigerio	CV
JACQUARD DOUBLE LAME IN SEMPLICE	Frigerio	CV
JACQUARD DOUBLE LAME' LIGHT	Frigerio	CV
JACQUARD DOUBLE LAME' TELA	Frigerio	CV
JACQUARD ECLIPSE ACC LIGHT	Taborelli	CE 10
JACQUARD ECLIPSE ACC TELA	Taborelli	CE 10
JACQUARD ECLIPSE ACC. REPS + IDRO BEROFIN	Taborelli	
JACQUARD ECLIPSE EDIL SPORT ACC.REPS+IDRO+DIR.FILO	Taborelli	
JACQUARD ECLIPSE EDIL SPORT IN SEMPLICE	Taborelli	
JACQUARD ECLIPSE IN SEMPLICE	Taborelli	CE 10
JACQUARD FENDI  PROVA 1  SEMPLICE	Frigerio	CSP
JACQUARD FENDI  PROVA 2  SEMPLICE	Frigerio	CSP
JACQUARD FENDI  PROVA 3  SEMPLICE	Frigerio	CSP
JACQUARD FENDI  PROVA 4  SEMPLICE	Frigerio	CSP
JACQUARD FENDI  PROVA 5  SEMPLICE	Frigerio	CSP
JACQUARD FENDI  PROVA A  SEMPLICE	Frigerio	CSP
JACQUARD FENDI  PROVA B  SEMPLICE	Frigerio	CSP
JACQUARD FENDI  PROVA C  SEMPLICE	Frigerio	CSP
JACQUARD FENDI  PROVA D  SEMPLICE	Frigerio	CSP
JACQUARD FENDI  PROVA E  SEMPLICE	Frigerio	CSP
JACQUARD FENDI  PROVA F  SEMPLICE	Frigerio	CSP
JACQUARD FENDI  PROVA G  SEMPLICE	Frigerio	CSP
JACQUARD FENDI  PROVA H  SEMPLICE	Frigerio	CSP
JACQUARD FENDI  PROVA I  SEMPLICE	Frigerio	CSP
JACQUARD FENDI  PROVA L  SEMPLICE	Frigerio	CSP
JACQUARD FENDI  PROVA M  SEMPLICE	Frigerio	CSP
JACQUARD FENDI ACC. LIGHT + IDRO	Frigerio	CSP
JACQUARD FH POLY 100	Frigerio	CSP
JACQUARD FIL COUPE' ACC  LIGHT BEROFIN	Frigerio	CSP
JACQUARD FIL COUPE' ACC REPS BEROFIN	Frigerio	CSP
JACQUARD FIL COUPE' IN SEMPLICE	Frigerio	CSP
JACQUARD FIL COUPE' IN SEMPLICE BEROFIN	Frigerio	CSP
JACQUARD GALLES ACC REPS BEROFIN	Taborelli	CSP
JACQUARD GALLES IN SEMPLICE	Taborelli	CSP
JACQUARD GEOX ACC. LIGHT BIANCO	Frigerio	CSP
JACQUARD GEOX ACC. LIGHT TINTO	Frigerio	CSP
JACQUARD GEOX ACC. LIGHT+ IDRO  BIANCO	Frigerio	CSP
JACQUARD GEOX ACC. REPS + IDRO BIANCO	Frigerio	CSP
JACQUARD GEOX ACC. REPS +IDRO TINTO	Frigerio	CSP
JACQUARD GEOX ACC. REPS BIANCO	Frigerio	CSP
JACQUARD GEOX ACC. REPS TINTO	Frigerio	CSP
JACQUARD GEOX ACC.LIGHT+IDRO TINTO	Frigerio	CSP
JACQUARD GEOX LIGHT IDRO	Frigerio	CSP
JACQUARD GEOX RESIN. IDRO	Frigerio	CSP
JACQUARD GEOX SEMPL. IDRO	Frigerio	CSP
JACQUARD GEOX TELA IDRO	Frigerio	CSP
JACQUARD GLAM ACC LIGHT	Frigerio	CV
JACQUARD GLAM ACC TELA	Frigerio	CV
JACQUARD GLAM IN SEMPLICE	Frigerio	CV
JACQUARD GUCCI LAVATO ACC JERSEY COL.CAMPIONE	Frigerio	CSP
JACQUARD GUCCI LAVATO ACC.JERSEY BIANCO	Frigerio	CSP
JACQUARD GUCCI LAVATO ACC.JERSEY NERO	Frigerio	CSP
JACQUARD GUCCI MAKO' EGITTO + PAN. COL. CHIARI +ID	Frigerio	
JACQUARD GUCCI MAKO' EGITTO + PANAMA BIANCO + IDRO	Frigerio	
JACQUARD GUCCI MAKO' EGITTO + PANAMA GARZ.+ IDRO	Frigerio	
JACQUARD GUCCI MAKO' EGITTO + PANAMA NERO +IDRO	Frigerio	
JACQUARD GUCCI MAKO' EGITTO + RES.+IDRO+DIR.FILO	Frigerio	
JACQUARD GUCCI MAKO' EGITTO ACC. LIGHT +IDRO	Frigerio	
JACQUARD GUCCI MAKO' IN SEMPLICE	Frigerio	
JACQUARD GUCCI ORIGINAL GG POLY +RESINA+IDRO	Frigerio	CSP
JACQUARD GUCCI PETTINATO AMERICA + RES.+IDRO+DIR.F	Frigerio	
JACQUARD GUCCI PETTINATO AMERICA ACC. LIGHT + IDRO	Frigerio	
JACQUARD GUCCI PETTINATO AMERICA IN SEMPLICE	Frigerio	
JACQUARD HARLEM  COMPAR RESINA + IDRO	Frigerio	CSP
JACQUARD HARLEM  COMPAR SOLO RESINA	Frigerio	CSP
JACQUARD HARLEM + MTP	Frigerio	CSP
JACQUARD HAWK  colorato ACC LIGHT	Frigerio	CI09/10
JACQUARD HAWK  colorato ACC TELA	Frigerio	CI09/10
JACQUARD HAWK  colorato IN SEMPLICE	Frigerio	CI09/10
JACQUARD HAWK  oro/arg  ACC LIGHT	Frigerio	
JACQUARD HAWK  oro/arg ACC TELA	Frigerio	
JACQUARD HAWK  oro/arg IN SEMPLICE	Frigerio	
JACQUARD HAWK 300 BIASIA ACC. LIGHT	Frigerio	
JACQUARD HAWK 300 BIASIA IN SEMPLICE	Frigerio	
JACQUARD HAWK 300 BIASIA LIGHT + IDRO BEROFIN	Frigerio	
JACQUARD HAWK 300 BIASIA RESINATO + IDRO	Frigerio	
JACQUARD HAWK 300 BIASIA SEMPLICE + IDRO EUROFINIS	Frigerio	
JACQUARD HAWK BIASIA EXPERT TELA	Frigerio	CSP
JACQUARD JEANS ACC. LIGHT	Gif	CV
JACQUARD JEANS ACC. TELA	Gif	CV
JACQUARD JEANS CELINE	Gif	CSP
JACQUARD JEANS CELINE acc. Doppio	Gif	CSP
JACQUARD JEANS IN SEMPLICE	Gif	CV
"JACQUARD JORDAN ""GG"" SPIANATO"	Frigerio	CSP
JACQUARD JORDAN ACC. LIGHT	Frigerio	CCL
JACQUARD JORDAN ACC. TELA	Frigerio	CCL
JACQUARD JORDAN ACC. TELA + BRINATURA	Frigerio	CSP
JACQUARD JORDAN DOPPIA TRAMA IN SEMPLICE	Frigerio	CSP
JACQUARD JORDAN DOPPIA TRAMA LIGHT	Frigerio	CSP
JACQUARD JORDAN DOPPIA TRAMA TELA	Frigerio	CSP
JACQUARD JORDAN FENDI DENIM+DIRIT.FILO+IDRO	Frigerio	CSP
JACQUARD JORDAN FENDI LIGHT DIRIT.FILO+IDRO	Frigerio	CSP
JACQUARD JORDAN FENDI REPS DIRITT.FILO+IDRO	Frigerio	CSP
JACQUARD JORDAN FENDI RESINA+DIRIT.FILO+IDRO	Frigerio	CSP
JACQUARD JORDAN GG.SPIANATO + IDRO	Frigerio	CSP
JACQUARD JORDAN GUCCI	Frigerio	CSP
JACQUARD JORDAN GUCCI SEMPLICE	Frigerio	CSP
JACQUARD JORDAN IN SEMP.+IDRO	Frigerio	CCL
JACQUARD JORDAN IN SEMPLICE	Frigerio	CCL
JACQUARD JORDAN LIGHT IDRO berofin	Frigerio	CCL
JACQUARD JORDAN NERO GIARDINI ACC. TELA	Frigerio	CSP
JACQUARD JORDAN NG  SPIAN.+CINZATO	Frigerio	CSP
JACQUARD JORDAN NG 2 SPIAN.+CINZATO	Frigerio	CSP
JACQUARD JORDAN RESINATO	Frigerio	
JACQUARD JORDAN RESINATO + IDRO	Frigerio	CCL
JACQUARD JORDAN SEMPLICE	Frigerio	CCL
JACQUARD JORDAN STRETCH ACC. LIGHT	Frigerio	CV
JACQUARD JORDAN STRETCH ACC. TELA	Frigerio	CV
JACQUARD JORDAN TELA BEROFIN	Frigerio	CCL
JACQUARD JORDAN/SMALL ACC. TELA	Frigerio	CV
JACQUARD JORDAN/SMALL IN  SEMPLICE	Frigerio	CV
JACQUARD JORDAN/SMALL TRAMA+BELLA ACC. LIGHT  EUR	Frigerio	CV
JACQUARD JORDAN/SMALL TRAMA+BELLA LIGHT	Frigerio	CV
JACQUARD JORDAN/SMALL TRAMA+BELLA SEMP.+IDRO	Frigerio	CV
JACQUARD JORDAN/SMALL TRAMA+BELLA TELA BEROFIN	Frigerio	CV
JACQUARD JORDAN/SMALLTRAMA+BELLA RESINATA + IDRO	Frigerio	CV
JACQUARD JUNGLE ACC LIGHT	Taborelli	CE 10
JACQUARD JUNGLE ACC TELA	Taborelli	CE 10
JACQUARD JUNGLE IN SEMPLICE	Taborelli	CE 10
JACQUARD KID ACC LIGHT	Frigerio	CSP
JACQUARD KID ACC TELA	Frigerio	CSP
JACQUARD KID IN SEMPLICE	Frigerio	CSP
JACQUARD KILT FENDI ACC LIGHT BEROFIN	Frigerio	CSP
JACQUARD KILT FENDI ACC REPS BEROFIN	Frigerio	CSP
JACQUARD KILT FENDI IN SEMPLICE	Frigerio	CSP
JACQUARD KILT FENDI IN SEMPLICE BEROFIN	Frigerio	CSP
JACQUARD KILT/QUADRETTINO BIS EDILSPORT	Taborelli	
JACQUARD KILT/QUADRETTINO BIS EDILSPORT REPS + IDR	Taborelli	
JACQUARD KILT/QUADRETTINO EDIL SPORT	Taborelli	
JACQUARD KILT/QUADRETTINO EDILSPORT REPS + IDR	Taborelli	
JACQUARD KOSMOS REPS	Frigerio	CV
JACQUARD KOSMOS RESINATO	Frigerio	CV
JACQUARD KOSMOS SEMPLICE	Frigerio	CV
JACQUARD KOSMOS SOFT	Frigerio	CV
JACQUARD KOSMOS TELA	Frigerio	CV
JACQUARD LAME' ACC. DENIM CIAO BIMBI	Frigerio	CSP
JACQUARD LAME' ACC. LIGHT	Frigerio	CCL
JACQUARD LAME' ACC. LIGHT X ILEANA	Frigerio	CSP
JACQUARD LAME' ACC. REPS	Frigerio	
JACQUARD LAME' ACC. TELA	Frigerio	CCL
JACQUARD LAME' ACC. TELA  + IDRO	Frigerio	CCL
JACQUARD LAME' FENDI DENIM+DIRIT.FILO+IDRO	Frigerio	CSP
JACQUARD LAME' FENDI LIGHT+DIRIT.FILO+IDRO	Frigerio	CSP
JACQUARD LAME' FENDI REPS+DIRIT.FILO+IDRO	Frigerio	CSP
JACQUARD LAME' FENDI RESINA+DIRIT.FILO+IDRO	Frigerio	CSP
JACQUARD LAME' IN SEMPLICE	Frigerio	CCL
JACQUARD LANA ROTTA  FENDI ACC LIGHT BEROFIN	Frigerio	CSP
JACQUARD LANA ROTTA  FENDI ACC REPS BEROFIN	Frigerio	CSP
JACQUARD LANA ROTTA  FENDI IN SEMPLICE	Frigerio	CSP
JACQUARD LANA ROTTA  FENDI IN SEMPLICE berofin	Frigerio	CSP
JACQUARD LINGOT ACC. LIGHT	Tat	CCL
JACQUARD LINGOT ACC. LYCRA	Tat	CCL
JACQUARD LINGOT ACC. REPS	Tat	CCL
JACQUARD LINGOT IN SEMPLICE	Tat	CCL
JACQUARD LINGOT NEW H 100 LIGHT	Taborelli	
JACQUARD LINGOT NEW H 100 SEMPLICE	Taborelli	CSP
JACQUARD LINGOT NEW H 100 TELA	Taborelli	CSP
JACQUARD LINGOT NEW H 130 LIGHT	Taborelli	CSP
JACQUARD LINGOT NEW H 130 SEMPLICE	Taborelli	CSP
JACQUARD LINGOT NEW H 130 TELA	Taborelli	CSP
JACQUARD LOTTO 100% PA DENIM	Frigerio	CSP
JACQUARD LOTTO 100% PA LIGHT	Frigerio	CSP
JACQUARD LOTTO 100% PA REPS	Frigerio	CSP
JACQUARD LOTTO 100% PA SEMPLICE	Frigerio	CSP
JACQUARD LOTTO 100% PL DENIM	Frigerio	CSP
JACQUARD LOTTO 100% PL LIGHT	Frigerio	CSP
JACQUARD LOTTO 100% PL REPS	Frigerio	CSP
JACQUARD LOTTO 100% PL SEMPLICE	Frigerio	CSP
"JACQUARD LUREX ""GG"" SEMPLICE"	Frigerio	CSP
JACQUARD LUREX BULGARI ACC. LIGHT + IDRO	Taborelli	CSP
JACQUARD LUREX NUOVO ACC. REPS GEOX	Frigerio	CSP
JACQUARD LUREX NUOVO ACC.TELA GEOX	Frigerio	CSP
JACQUARD LUREX NUOVO IN SEMPLICE GEOX	Frigerio	CSP
JACQUARD MARINE RESINATO	Taborelli	CSP
JACQUARD METAL ACC. LIGHT LAME'	Frigerio	CV
JACQUARD METAL ACC. TELA + IDRO LAME'	Frigerio	CCL
JACQUARD METAL ACC. TELA EXPERT	Frigerio	CCL
JACQUARD METAL LAME' IN SEMPLICE	Frigerio	CCL
JACQUARD METAL RESIN.+ IDRO LAME'	Frigerio	CCL
JACQUARD MINUS	Frigerio	CV
JACQUARD MIRIADE ACC. LIGHT  METAL	Taborelli	CSP
JACQUARD MIRIADE ACC. LIGHT NO METAL	Taborelli	CSP
JACQUARD MIRIADE ACC. TELA METAL	Taborelli	CSP
JACQUARD MIRIADE ACC. TELA NO METAL	Taborelli	CSP
JACQUARD MIRIADE IN SEMPLICE METAL	Taborelli	CSP
JACQUARD MIRIADE IN SEMPLICE NO METAL	Taborelli	CSP
JACQUARD NANNINI RAFIA ACC. LIGHT	Taborelli	CSP
JACQUARD NANNINI RAFIA ACC.TELA + IDRO	Taborelli	CSP
"JACQUARD NASTRO ""GG"" SEMPLICE"	Frigerio	CSP
JACQUARD NYLON GEOX VERDE ACC. TELA	Corti	CSP
JACQUARD ORANGE ACC TELA	Taborelli	CCL
JACQUARD ORANGE ACC. LIGHT	Taborelli	CCL
JACQUARD ORANGE ACC. REPS + IDRO BEROFIN	Taborelli	
JACQUARD ORANGE IN SEMPLICE	Taborelli	CCL
JACQUARD OXIDE ACC LIGHT	Taborelli	CI09/10
JACQUARD OXIDE ACC REPS	Taborelli	CI09/10
JACQUARD OXIDE FENDI DENIM+DIRIT.FILO+IDRO	Taborelli	CSP
JACQUARD OXIDE FENDI LIGHT+DIRIT.FILO+IDRO	Taborelli	CSP
JACQUARD OXIDE FENDI REPS+DIRIT.FILO+IDRO	Taborelli	CSP
JACQUARD OXIDE FENDI RESINA+DIRIT.FILO+IDRO	Taborelli	CSP
JACQUARD OXIDE IN SEMPLICE	Taborelli	CI09/10
JACQUARD PELLICO IN SEMPLICE NEW	Frigerio	CSP
JACQUARD PELLICO NEW ACC. TELA	Frigerio	CSP
JACQUARD PENNY  IN SEMPLICE	Taborelli	CSP
JACQUARD PENNY D&A ACC. REPS	Taborelli	CSP
JACQUARD PENNY D&A ACC. TELA	Taborelli	CSP
JACQUARD PENNY D&A RESINATO	Taborelli	CSP
JACQUARD PENNY FENDI DENIM+DIRIT.FILO+IDRO	Taborelli	CSP
JACQUARD PENNY FENDI LIGHT+DIRIT.FILO+IDRO	Taborelli	CSP
JACQUARD PENNY FENDI REPS+DIRIT.FILO+IDRO	Taborelli	CSP
JACQUARD PENNY FENDI RESINA+DIRIT.FILO+IDRO	Taborelli	CSP
JACQUARD PENNY IN SEMPLICE	Taborelli	CCL
JACQUARD PENNY PAKERSON RESINATO	Taborelli	CSP
JACQUARD PENNY PUNITO	Taborelli	
JACQUARD PENNY RESINATO + DIR.FILO+IDRO	Taborelli	CCL
JACQUARD PEQUIN LIGHT	Frigerio	CSP
JACQUARD PEQUIN LUREX ORO SCURO LIGHT + IDRO	Frigerio	CSP
JACQUARD PICASSO FENDI ACC LIGHT BEROFIN	Taborelli	CSP
JACQUARD PICASSO FENDI ACC REPS BEROFIN	Taborelli	CSP
JACQUARD PICASSO FENDI IN SEMPLICE	Taborelli	CSP
JACQUARD PICASSO FENDI IN SEMPLICE BEROFIN	Taborelli	CSP
JACQUARD PLISSE'	Taborelli	CCL
JACQUARD PLUME ACC DENIM	Frigerio	CI09/10
JACQUARD PLUME ACC LIGHT	Frigerio	CI09/10
JACQUARD PLUME ACC. LIGHT + IDRO BEROFIN	Frigerio	
JACQUARD PLUME IN SEMPLICE	Frigerio	CI09/10
"JACQUARD RASO ""GG"" SEMPLICE"	Frigerio	CSP
"JACQUARD RASO ""GG""ACC. RETE DOPPIA FRONTURA"	Frigerio	
JACQUARD RIGA DIS.2 H & B	Frigerio	CSP
JACQUARD ROCCO BAROCCO ACC. LIGHT VI/LA	Taborelli	CSP
JACQUARD ROCCO BAROCCO ACC. TELA VI/LA	Taborelli	CSP
JACQUARD ROCCO BAROCCO IN SEMPLICE VI/LA	Taborelli	CSP
JACQUARD ROCCO BAROCCO RESINATO VI/LA	Taborelli	CSP
JACQUARD ROCCOBAROCCO INVERNO TELA NERA	Taborelli	CSP
JACQUARD SAND LIGHT	Frigerio	CE 12
JACQUARD SAND REPS	Frigerio	CE 12
JACQUARD SAND SEMPLICE	Frigerio	CE 12
JACQUARD SATIN  BIANCO ACC.LIGHT	Frigerio	CV
JACQUARD SATIN BIANCO ACC. REPS	Frigerio	CV
JACQUARD SATIN TINTO ACC. LIGHT	Frigerio	CV
JACQUARD SATIN TINTO ACC. REPS	Frigerio	CV
JACQUARD SATIN TINTO IN SEMPLICE	Frigerio	CV
JACQUARD SCOTTISH ACC REPS BEROFIN	Frigerio	CSP
JACQUARD SCOTTISH IN SEMPLICE	Frigerio	CSP
JACQUARD SCOZZESE COTONE GEOX	Taborelli	
JACQUARD SEX WAVE CAVALLI ACC. LIGHT	Taborelli	
JACQUARD SEX WAVE CAVALLI IN SEMPLICE	Taborelli	
JACQUARD SILVER BRIC'S COLORATO	Taborelli	CSP
JACQUARD SILVER BRIC'S NERO	Taborelli	CSP
JACQUARD SILVER COLORATO	Taborelli	CV
JACQUARD SILVER NERO	Taborelli	CV
JACQUARD SILVER NG IN SMPLICE	Frigerio	CSP
JACQUARD SMALL ACC. LIGHT + IDRO	Frigerio	CCL
JACQUARD SMALL ACC. LIGHT + IDRO EUROFINISS	Frigerio	CCL
JACQUARD SMALL ACC. LIGHT NO IDRO	Frigerio	CCL
JACQUARD SMALL ACC. LIGHT+IDRO BEROFIN	Frigerio	CCL
JACQUARD SMALL ACC. REPS	Frigerio	
JACQUARD SMALL ACC. TELA	Frigerio	CCL
JACQUARD SMALL ACC.TELA BEROFIN	Frigerio	CCL
JACQUARD SMALL DESERT  ACC. LIGHT	Frigerio	CV
JACQUARD SMALL DESERT ACC. TELA	Frigerio	CV
JACQUARD SMALL DESERT IN SEMPLICE	Frigerio	CV
JACQUARD SMALL IN SEMPLICE	Frigerio	CCL
JACQUARD SMALL IN SEMPLICE + IDRO	Frigerio	CCL
JACQUARD SMALL KITON RESINA+ DIRITTO FILO	Frigerio	CSP
JACQUARD SMALL KITON RESINA+DIRITTO FILO	Frigerio	CSP
JACQUARD SMALL LAME' ORO/BEIGE  LIGHT	Frigerio	CCL
JACQUARD SMALL LAME' ORO/BEIGE IN SEMP.	Frigerio	CCL
JACQUARD SMALL LAME' ORO/BEIGE TELA	Frigerio	CCL
JACQUARD SMALL NERO GIARDINI ACC. TELA	Frigerio	CSP
JACQUARD SMALL RESINATO	Frigerio	CCL
JACQUARD SMALL RESINATO IDRO BEROFIN	Frigerio	CCL
JACQUARD SMILE ACC LIGHT	Frigerio	CE 10
JACQUARD SMILE ACC REPS	Frigerio	CE 10
JACQUARD SMILE IN SEMPLICE	Frigerio	CE 10
JACQUARD SMOKY ACC. REPS	Taborelli	CCL
JACQUARD SMOKY ACC.LIGHT	Taborelli	CCL
JACQUARD SMOKY ACC.TELA	Taborelli	CCL
JACQUARD SMOKY IN SEMPLICE	Taborelli	CCL
JACQUARD SPIGATO ACC TELA	Frigerio	CSP
JACQUARD ST. LOUIS BALLY TELA IDRO	Tat	CSP
JACQUARD ST.LOUIS BALLY INTERLOCK IDRO	Tat	CSP
JACQUARD ST.LOUIS BALLY LIGHT IDRO	Tat	CSP
JACQUARD ST.LOUIS BALLY SEMPLICE IDRO	Tat	CSP
JACQUARD STAR  NERO/COLORATO ACC. LIGHT	Frigerio	CI09/10
JACQUARD STAR  NERO/COLORATO ACC. TELA	Frigerio	
JACQUARD STAR  NERO/COLORATO ACC.REPS + IDRO	Frigerio	CCL
JACQUARD STAR FENDI DENIM+DIRIT.FILO+IDRO	Frigerio	CSP
JACQUARD STAR FENDI LIGHT+DIRIT.FILO+IDRO	Frigerio	CSP
JACQUARD STAR FENDI REPS+DIRIT.FILO+IDRO	Frigerio	CSP
JACQUARD STAR FENDI RESINA+DIRIT.FILO+IDRO	Frigerio	CSP
JACQUARD STAR NERO/COLORATO  ACC.  LIGHT + IDRO	Frigerio	CI09/10
JACQUARD STAR NERO/COLORATO  ACC. TELA + IDRO	Frigerio	CCL
JACQUARD STAR NERO/COLORATO  IN SEMPLICE	Frigerio	CCL
JACQUARD STAR NERO/COLORATO  light	Frigerio	CI09/10
JACQUARD STAR NERO/COLORATO  REPS	Frigerio	CI09/10
JACQUARD STAR NERO/COLORATO TELA	Frigerio	
JACQUARD STAR ORO/ARG REPS	Frigerio	CI09/10
JACQUARD STAR ORO/ARG SEMPLICE	Frigerio	CI09/10
JACQUARD STAR ORO/ARGENTO TELA	Frigerio	
JACQUARD STRETCH ACC. LIGHT	Frigerio	CV
JACQUARD STRETCH ACC. TELA	Frigerio	CV
JACQUARD STRETCH IN SEMPLICE	Frigerio	CV
JACQUARD STRETCH LUREX ACC. LIGHT	Taborelli	CV
JACQUARD STRETCH LUREX ACC. REPS	Taborelli	CV
JACQUARD STRETCH LUREX IN SEMPLICE	Taborelli	CV
JACQUARD SUITE ACC LIGHT	Frigerio	CCL
JACQUARD SUITE ACC REPS	Frigerio	CCL
JACQUARD SUITE ACC TELA	Frigerio	CCL
JACQUARD SUITE ACC. INETRLOCK NERO	Frigerio	CCL
JACQUARD SUITE ACC.INTERLOCK NERO + IDRO	Frigerio	CCL
JACQUARD SUITE EXTRA IN SEMPLICE	Frigerio	CSP
JACQUARD SUITE FENDI DENIM+DIRIT.FILO+IDRO	Frigerio	CSP
JACQUARD SUITE FENDI LIGHT+DIRIT.FILO+IDRO	Frigerio	CSP
JACQUARD SUITE FENDI REPS+DIRIT.FILO+IDRO	Frigerio	CSP
JACQUARD SUITE FENDI RESINA+DIRIT.FILO+IDRO	Frigerio	CSP
JACQUARD SUITE FERRAGAMO REPS	Frigerio	CSP
JACQUARD SUITE FERRAGAMO SEMPLICE	Frigerio	CSP
JACQUARD SUITE FERRAGAMO TELA	Frigerio	CSP
JACQUARD SUITE IN SEMPLICE	Frigerio	CCL
JACQUARD SUITE NERO GIARDINI ACC. TELA	Frigerio	CSP
JACQUARD SUITE ROYALE SEMPLICE	Frigerio	CSP
JACQUARD SUNRISE ACC LIGHT	Taborelli	CE 10
JACQUARD SUNRISE ACC TELA	Taborelli	CE 10
JACQUARD SUNRISE IN SEMPLICE	Taborelli	CE 10
JACQUARD SUNSET ACC LIGHT	Taborelli	CE 10
JACQUARD SUNSET ACC REPS	Taborelli	CE 10
JACQUARD SUNSET IN SEMPLICE	Taborelli	CE 10
JACQUARD TARTAN FENDI  SEMPLICE	Frigerio	CSP
JACQUARD TARTAN FENDI NUOVO DENIM	Frigerio	CSP
JACQUARD TARTAN FENDI NUOVO LIGHT	Frigerio	CSP
JACQUARD TARTAN FENDI NUOVO RESINATO	Frigerio	CSP
JACQUARD TARTAN FENDI RESINATO	Frigerio	CSP
JACQUARD TARTAN LUCIDO FENDI ACC LIGHT BEROFIN	Frigerio	CSP
JACQUARD TARTAN LUCIDO FENDI ACC REPS BEROFIN	Frigerio	CSP
JACQUARD TARTAN LUCIDO FENDI IN SEMPLICE	Frigerio	CSP
JACQUARD TARTAN LUCIDO FENDI IN SEMPLICE berofin	Frigerio	CSP
JACQUARD TARTAN OPACO FENDI ACC LIGHT	Frigerio	CSP
JACQUARD TARTAN OPACO FENDI ACC REPS	Frigerio	CSP
JACQUARD TARTAN OPACO FENDI IN SEMPLICE	Frigerio	CSP
JACQUARD TARTAN OPACO FENDI IN SEMPLICE BEROFIN	Frigerio	CSP
JACQUARD TEKNO ACC LIGHT BEROFIN	Taborelli	CI 10/11
JACQUARD TEKNO ACC REPS BEROFIN	Taborelli	CI 10/11
JACQUARD TEKNO DENIM	Taborelli	CSP
JACQUARD TEKNO IN SEMPLICE	Taborelli	CSP
JACQUARD TEKNO RESINATO BEROFIN	Taborelli	CI 10/11
JACQUARD TUBE ACC. LIGHT	Frigerio	CCL
JACQUARD TUBE ACC. TELA	Frigerio	CCL
JACQUARD TUBE FENDI DENIM+DIRIT.FILO+IDRO	Frigerio	CSP
JACQUARD TUBE FENDI LIGHT+IDRO	Frigerio	CSP
JACQUARD TUBE FENDI REPS+DIRIT.FILO+IDRO	Frigerio	CSP
JACQUARD TUBE FENDI RESINA+DIRIT.FILO+IDRO	Frigerio	CSP
JACQUARD TUBE IN SEMPLICE	Frigerio	CCL
JACQUARD TUBE REPS	Frigerio	CCL
JACQUARD TUBE SEMPLICE + IDRO+D FILO	Frigerio	CSP
JACQUARD TUBICO OPACO ACC LIGHT BEROFIN	Frigerio	CSP
JACQUARD TUBICO OPACO ACC REPS BEROFIN	Frigerio	CSP
JACQUARD TUBICO OPACO IN SEMPLICE	Frigerio	CSP
JACQUARD TUBICO OPACO IN SEMPLICE BEROFIN	Frigerio	CSP
JACQUARD TWILL LIGHT	Frigerio	CSP
JACQUARD TWILL RESINATO	Frigerio	CI 10/11
JACQUARD WOOL LIGHT	Frigerio	CSP
JACQUARD WOOL REPS BEROFIN	Frigerio	CSP
JACQUARD WOOL SEMPLICE	Frigerio	
"JACQUARD ZUCCA ""GUCCI""RESINA+DIR.FILO+CALANDR"	Frigerio	CSP
"JACQUARD ZUCCA ""GUCCI""RESINA+DIR.FILO+idro"	Frigerio	CSP
JACQUARD ZUCCA FENDI ACC.LIGHT	Frigerio	CSP
JACQUARD ZUCCA FENDI ACC.LIGHT (7,00) supp.  1,05	Frigerio	CSP
JACQUARD ZUCCA FENDI ACC.LIGHT (7,10) supp.  1,05	Frigerio	CSP
JACQUARD ZUCCA FENDI ACC.LIGHT (7,20) supp.  1,05	Frigerio	CSP
JACQUARD ZUCCA FENDI EURO 13,80 ACC.LIGHT	Frigerio	
JACQUARD ZUCCA FENDI LIGHT FINO AL 31/12/2010	Frigerio	
JAIME LIGHT	Corti	CV
JAIME RESINATO	Corti	CV
JAIME SEMPLICE	Corti	CV
JAIME SOFT	Corti	CV
JAIME TELA	Corti	CV
JAKAY	Lange	CV
JAKKO	Fillattice	CV
JALYN	Heat Coat	CV
JAM  GROUND	Corti	CV
JAM DENIM	Piave	CV
JAM FIVE ACC. LIGHT	Corti	CV
JAM FIVE ACC. TELA	Corti	CV
JAM FIVE IN SEMPLICE	Corti	CV
JAM METAL ACC. LIGHT	Corti	CV
JAM METAL ACC. TELA	Corti	CV
JAM METAL IN SEMPLICE	Corti	CV
JAM NINE	Corti	CV
JAM STRETCH	Piave	CV
JAM STRIPE LIGHT	My Way	CV
JAM STRIPE LIGHT MONOV.	My Way	CV
JAM STRIPE REPS	My Way	CV
JAM STRIPE REPS MONOV.	My Way	CV
JAM STRIPE RESIN. MONOV.	My Way	CV
JAM STRIPE RESINATO	My Way	CV
JAM STRIPE SEMPLICE	My Way	CV
JAM STRIPE SEMPLICE MONOVARIANTE	My Way	CV
JAM STRIPE SOFT	My Way	CV
JAM STRIPE SOFT MONOV.	My Way	CV
JAM STRIPE TELA	My Way	CV
JAM STRIPE TELA MONOV.	My Way	CV
JAM ZERO  ACC. LIGHT	Corti	CCL
JAM ZERO  ACC. TELA	Corti	CCL
JAM ZERO  IN SEMPLICE	Corti	CCL
JAM ZERO VAR. ORO/ARGENTO  ACC. LIGHT	Corti	CCL
JAM ZERO VAR. ORO/ARGENTO  ACC.TELA	Corti	CCL
JAM ZERO VAR.ORO/ARGENTO IN SEMPLICE	Corti	CCL
JAMAAL ACC. LIGHT	Taborelli	CV
JAMAAL ACC. REPS	Taborelli	CV
JAMAAL IN SEMPLICE	Taborelli	CV
JAMAICAN BIANCO	Miti	CV
JAMAICAN COLORATI	Miti	CV
JAMAICAN NERO	Miti	CV
JAMES ACC. REPS	My Way	CCL
JAMES LIGHT	My Way	CCL
JAMES SEMPLICE	My Way	CCL
JAMES TELA	My Way	CCL
JAMFLOWER LIGHT	Lange	CV
JAMFLOWER SEMPLICE	Lange	CV
JAMFLOWER TELA	Lange	CV
JAMI	Cifra	CV
JAMIR ACC. TELA	Ambiente Uomo	CV
JAMIR LIGHT	Ambiente Uomo	CV
JAMIR REPS	Ambiente Uomo	CV
JAMIR RESINATO	Ambiente Uomo	CV
JAMIR SEMPLICE	Ambiente Uomo	CV
JAMIR SOFT	Ambiente Uomo	CV
JAMIRO	Mariani cinese	CV
JAMIRO STRETCH ACC DENIM	Ciemme	CI 11/12
JAMIRO STRETCH ACC STRETCH	Ciemme	CI 11/12
JAMIRO STRETCH SEMPLICE	Ciemme	CI 11/12
JAMISON ACC. LYCRA  ORO/ARG.	Piave	CV
JAMISON ACC. LYCRA COLORATA	Piave	CV
JAMISON ACC. LYCRA NERA COLORATI	Piave	CV
JAMISON ACC. LYCRA NERA ORO/ARGENTO	Piave	CV
JAMISON COLORATI	Piave	CCL
JAMISON ORO ARGENTO	Piave	CCL
JAMMER	Lange	CV
JAMMY	My Way	CV
JAMMY MONOVARIANTE	My Way	CV
JAMPUR STERTCH ACC. TELA	Forma	CV
JAMPUR STRETCH ACC.LIGHT	Forma	CV
JAMPUR STRETCH REPS	Forma	CV
JAMPUR STRETCH SEMPLICE	Forma	CV
JAMPUR STRETCH STRETCH	Forma	CV
JAMSTREIPE LIGHT MONOVARIANTE	My Way	CV
JAMSTRIPE LIGHT	My Way	CV
JAMSTRIPE REPS	My Way	CV
JAMSTRIPE REPS MONOVARIANTE	My Way	CV
JAMSTRIPE RESINATE	My Way	CV
JAMSTRIPE RESINATO MONOVARIANTE	My Way	CV
JAMSTRIPE SEMPLICE	My Way	CV
JAMSTRIPE SEMPLICE MONOVARIANTE	My Way	CV
JAMSTRIPE SOFT	My Way	CV
JAMSTRIPE SOFT MONOVARIANTE	My Way	CV
JAMSTRIPE TELA	My Way	CV
JAMSTRIPE TELA MONOVARIANTE	My Way	CV
JAMZERO ACC. TELA COLORATO	Corti	CV
JANIS	Dalmatex	CCL
JAQUARD BALLY INTERLOCK IDRO	Tat	CSP
JAQUARD BALLY SEMPLICE IDRO	Tat	CSP
JAQUARD BALLY TELA IDRO	Tat	CSP
JARVIS ACC. LIGHT	Taborelli	CV
JARVIS ACC. REPS	Taborelli	CV
JARVIS IN SEMPLICE	Taborelli	CV
JASIKY	Gif	CV
JASMIN	Tat	CV
JASON	My Way	CCL
JASON RESINATO	My Way	CV
JASON SEMPLICE	My Way	CV
JASON SOFT	My Way	CV
JASON TELA	My Way	CV
JAVA BASE BIANCA LIGHT	Mariani cinese	CV
JAVA BASE BIANCA REPS	Mariani cinese	CV
JAVA BASE COLORATA LIGHT REPS	Mariani cinese	CV
JAVA BASE COLORATA REPS	Mariani cinese	CV
JAVAN	Ambiente Uomo	CV
JAXON	Corti	CV
JAXSON STAPATO MONOCOLORE SU PU	Corti	CV
JAY	Lange	CV
JAY ACC  TELA	Taborelli	CCL
JAY ACC LIGHT	Taborelli	CCL
JAY IN SEMPLICE	Taborelli	CCL
JAYAN LIGHT	Ambiente Uomo	CV
JAYAN REPS	Ambiente Uomo	CV
JAYAN RESINATO	Ambiente Uomo	CV
JAYAN SEMPLICE	Ambiente Uomo	CV
JAYAN SOFT	Ambiente Uomo	CV
JAZZ	Corti	CV
JAZZ ABB.	Erco Pizzi	CV
JAZZ REPS	Gif	CV
JAZZ SEMPLICE	Gif	CV
JAZZ SOFT	Gif	CV
JAZZ SPALMATO	Gif	CV
JEANXY  LANGE' ACC. REPS	Lange	CCL
JEANXY ACC. TELA + IDRO BEROFIN	Uco	CCL
JEANXY ACC.LIGHT	Italdenim	CCL
JEANXY ANTIFILO	Uco	CCL
JEANXY BIANCO  ESCADA +PVC  LUCIDO ACC. TELA	Uco	CSP
JEANXY BIANCO ESCADA +PU  LUCIDO ACC. TELA	Uco	CSP
JEANXY BIANCO ESCADA +PU  LUCIDO IN SEMP.	Uco	CSP
JEANXY BIANCO ESCADA +PU  SOLARI IN SEMP.	Uco	CSP
JEANXY BIANCO ESCADA +PU OPACO  IN SEMP.	Uco	CSP
JEANXY BIANCO ESCADA +PU OPACO ACC. TELA	Uco	CSP
JEANXY BIANCO ESCADA +PU SOLARI ACC. TELA	Uco	CSP
JEANXY BIANCO ESCADA +PVC  LUCIDO IN SEMP.	Uco	CSP
JEANXY CELINE DENIM IDRO	Gif	CSP
JEANXY CELINE REPS IDRO	Gif	CSP
JEANXY CELINE TELA IDRO	Gif	CSP
JEANXY CRINKLE IN SEMPLICE	Italdenim	CV
JEANXY CRINKLE IN SEMPLICE + IDRO	Uco	CV
JEANXY IN SEMPLICE LAVATO	Uco	CCL
JEANXY LANGE' ACC. LIGHT	Lange	CCL
JEANXY LANGE' ACC. SOFT	Lange	CCL
JEANXY LANGE' ACC. TELA	Lange	CCL
JEANXY LANGE' INSEMPLICE	Lange	CCL
JEANXY LANGE' RESINATO	Lange	CCL
JEANXY REPS	Italdenim	CCL
JEANXY RESINATO	Uco	CCL
JEANXY SABBIATO	Uco	CV
JEANXY SEMPLICE	Italdenim	CCL
JEANXY SOFT	Uco	CCL
JEANXY STAMPA ESCADA ACC. TELA	Uco	CSP
JEANXY STAMPA ESCADA IN SEMPLICE	Uco	CSP
JEANXY STRETCH ACC.LIGHT	Tat	CV
JEANXY STRETCH ACC.REPS	Tat	CV
JEANXY STRETCH IN SEMPLICE	Tat	CV
JEANXY TELA	Italdenim	CCL
JEANXY TRAMA NUOVA PRONTO STAMPA	Gif	CSP
JEFF ACC LIGHT	Corti	CV
JEFF ACC REPS	Corti	CV
JEFF ACC.LIGHT + IDRO BEROFIN	Corti	CSP
JEFF IN SEMPLICE	Corti	CV
JEFF LIGHT + IDRO	Corti	CSP
JEFFA	Corti	CV
JELLY	Lange	CCL
JENKINS BIANCO/NERO	Pozzi	CE 10
JENKINS FIVE	Pozzi	CE 10
JERIKO	Namsan Technology	CV
JERMAIN ACC. LIGHT	Taborelli	CV
JERMAIN ACC. TELA	Taborelli	CV
JERMAIN IN SEMPLICE	Taborelli	CV
JEROME ACC. LIGHT	Corti	CV
JEROME RESINATO	Corti	CV
JEROME SEMPLICE	Corti	CV
JEROME SOFT	Corti	CV
JEROME TELA	Corti	CV
JET BLACK ACC TELA	Corti	CCL
JET BLACK ACC TELA + ANTISFILO	Corti	CSP
JET BLACK ACC. LIGHT	Corti	CCL
JET BLACK ACC. REPS	Corti	CCL
JET BLACK IN SEMPLICE	Corti	CCL
JET BLACK REPS + IDRO	Corti	CCL
JET BLUE ACC. LIGHT	Corti	CCL
JET BLUE ACC. TELA	Corti	CCL
JET BLUE IN SEMPLICE	Corti	CCL
JET METAL  ACC REPS	Corti	CI 10/11
JET METAL  IN SEMPLICE	Corti	CI 10/11
JET METAL ACC LIGHT	Corti	CI 10/11
JET METAL DENIM + IDRO	Corti	CSP
JET SUN ACC. LIGHT	Dalmatex	CV
JET SUN ACC. REPS	Dalmatex	CV
JET SUN IN SEMPLICE	Dalmatex	CV
JEWEL ACC. LIGHT	Frigerio	CV
JEWEL ACC. REPS	Frigerio	CV
JEWEL ACC.TELA	Frigerio	CV
JEWEL IN SEMPLICE	Frigerio	CV
JEWEL RESINATO	Frigerio	CV
JIGGY	Cifra	CV
JIMIX ACC. DENIM + IDRO	Lange	CSP
JIMIX ACC. LIGHT + IDRO BEROFIN	Lange	CCL
JIMIX ACC. TELA + IDRO	Lange	CCL
JIMIX ACC.DENIM BIANCO + IDRO BEROFIN	Lange	CV
JIMIX ACC.LIGHT	Lange	CCL
JIMIX BIANCO IN SEMPLICE MT.300	Lange	
JIMIX BIANCO STAMPA	Lange	CSP
JIMIX BIFACE SOLIDO + MACCHIA BIANCA		CV
JIMIX BIFACE SOLIDO + MACCHIA BOANCA	Lange	CV
JIMIX CRINCLE TELA	Lange	CCL
JIMIX CRINKLE  IN SEMPLICE + IDRO	Lange	CCL
JIMIX CRINKLE ACC. LIGHT	Lange	CCL
JIMIX CRINKLE RESINATO	Lange	CCL
JIMIX CRINKLE SEMPLICE	Lange	CCL
JIMIX DENIM EXPERT	Lange	CSP
JIMIX DIS. LEGEND SEMPLICE	Lange	CV
JIMIX FLOWER LIGHT	Lange	CV
JIMIX FLOWER SEMPLICE	Lange	CV
JIMIX FLOWER TELA	Lange	CV
JIMIX GLASS	Lange	CCL
JIMIX IDRO EUROFINISS	Lange	CSP
JIMIX IN SEMPLICE NUOVI	Lange	CSP
JIMIX NERO IN SEMPLICE MT.300	Lange	
JIMIX OLEATO SEMPLICE	Lange	CV
JIMIX OLEATO SOFT	Lange	CV
JIMIX OLEATO TELA	Lange	CV
JIMIX PRONTO STAMPA SEMP.+ST INK JET -LUCE	Lange	CSP
JIMIX PRONTO STAMPA SEMP.+ST INK JET LUCE da mt101	Lange	CSP
JIMIX PRONTO STAMPA TELA.+ST INK JET -LUCE	Lange	CSP
JIMIX PRONTO STAMPA TELA+ST INK JET -LUCE DA MT101	Lange	CSP
JIMIX RESINATO BEROFIN	Lange	CSP
JIMIX SEMPLICE	Lange	CV
JIMIX SOFT	Lange	CV
JIMIX STAMPATO TIMBERLAN IN SEMPLICE	Lange	CSP
JIMIX STAMPATO TIMBERLAND ACC. LIGHT	Lange	CSP
JIMIX STAMPATO TIMBERLAND ACC. TELA	Lange	CSP
JIMIX STAMPATO TIMBERLAND RESINATO	Lange	CSP
JIMIX TELA	Lange	CV
JIRI	Frigerio	CV
JODY  colorato tela bianca	Piave	CV
JODY BIANCO	Piave	CV
JODY NERO tela nera	Piave	CV
JOE CUBA BIANCO NERO	Fillattice	CV
JOE CUBA COLORATI	Fillattice	CV
JOE MESH BIANCO	Miti	CV
JOE MESH COLORATI	Miti	CV
JOE MESH NERO	Miti	CV
JOE WILD	Itm	CV
JOE WILD REPS	Itm	CV
JOE WILD SOFT	Itm	CV
JOE WILD TELA	Itm	CV
JOEL	Sat idea	CV
JOEL  ACC. LIGHT COLORATO DIS. 3152	Lange	CV
JOEL ACC. LIGHT	Lange	CV
JOEL ACC. LIGHT VAR.ORO/ARGENTO DIS.3152	Lange	CV
JOEL ACC. TELA	Lange	CV
JOEL ACC. TELA COLORATO DIS. 3152	Lange	CV
JOEL ACC.TELA VAR.ORO/ARGENTO DIS.3152	Lange	CV
JOEL IN SEMPLICE	Lange	CV
JONES	Gif	CV
JORDAN 5 TRAME CREA SEMPLICE	Frigerio	CSP
JORDAN 5 TRAME CREA TELA IDRO	Frigerio	CSP
JORDAN FLOWER LIGTH	Frigerio	CV
JORDAN FLOWER SEMPLICE	Frigerio	CV
JORDAN FLOWER TELA	Frigerio	CV
JORDAN STONE LIGHT	Frigerio	CV
JORDAN STONE SEMPLICE	Frigerio	CV
JORDAN STONE TELA	Frigerio	CV
JORDY ACC. LIGHT	Taborelli	CV
JORDY ACC. TELA	Taborelli	CV
JORDY IN SEMPLICE	Taborelli	CV
JOSHUA ACC LIGHT	Taborelli	CI09/10
JOSHUA ACC REPS	Taborelli	CI09/10
JOSHUA IN SEMPLICE	Taborelli	CI09/10
JOSS	Uco	CV
JOY	Unotex	CV
JUANITO	Corti	CV
JUBLE'	Lange	CV
JULIUS  REPS	Corti	CV
JULIUS LIGHT	Corti	CV
JULIUS RESINATO	Corti	CV
JULIUS SEMPLICE	Corti	CV
JUMAL ACC. LIGHT	Taborelli	CV
JUMAL ACC. REPS	Taborelli	CV
JUMAL IN SEMPLICE	Taborelli	CV
JUMP	Carvico	CV
JUMPER	Lange	CV
JUMPIN	Forma	CV
JUNGLE LIGHT	Mariani cinese	CV
JUNGLE TELA	Mariani cinese	CV
JUNGLEST  REPS	Mariani cinese	CV
JUST ONE	Dalmatex	CI09/10
JUSTIN	My Way	CSP
JUSTIN + TRAPUNTA	My Way	CSP
JUSTIN ACC TELA + STAMPA INK JET	My Way	CSP
JUSTIN ACC. TELA RIGATO	My Way	CSP
JUSTIN BOUCLE' ACC. LOFT	My Way	CCL
JUSTIN CRINKEL ACC. LIGHT	My Way	CV
JUSTIN CRINKEL ACC. REPS	My Way	CV
JUSTIN CRINKEL SEMPLICE	My Way	CV
JUSTIN DENIM	My Way	CCL
JUSTIN INVECCHIATO (ETNICO) ACC. TELA	My Way	CV
JUSTIN KING	My Way	CCL
JUSTIN LAVORAZ.VELVET FIVE ACC. REPS	My Way	CV
JUSTIN LAVORAZIONE WHITE SPIRIT	My Way	
JUSTIN LIGHT	My Way	CCL
JUSTIN METAL  ACC. TELA colorato	My Way	CCL
JUSTIN METAL  ACC. TELA oro/ argento	My Way	CCL
JUSTIN METAL + TRAPUNTA COLORATO	My Way	CV
JUSTIN METAL + TRAPUNTA ORO/ARGENTO	My Way	CV
JUSTIN METAL ACC. LIGHT colorato	My Way	CCL
JUSTIN METAL ACC. LIGHT oro/argento	My Way	CCL
JUSTIN METAL ACC. REPS COLORATO	My Way	CCL
JUSTIN METAL ACC. REPS ORO/ARGENTO	My Way	CCL
JUSTIN METAL CRINKLE ACC. LIGHT COL.	My Way	CV
JUSTIN METAL CRINKLE ACC. LIGHTORO/ARG.	My Way	CV
JUSTIN METAL CRINKLE ACC. TELA  COL.	My Way	CV
JUSTIN METAL CRINKLE ACC. TELA ORO/ARG.	My Way	CV
JUSTIN METAL CRINKLE SEMPLICE COL.	My Way	CV
JUSTIN METAL CRINKLE SEMPLICE ORO/ARG.	My Way	CV
JUSTIN METAL IN SEMPLICE colorato	My Way	CV
JUSTIN METAL IN SEMPLICEoro/argento	My Way	CV
JUSTIN METAL LAVORAZ. VELVET FIVE  REPS	My Way	CV
JUSTIN METAL LIZARD ACC. TELA	My Way	CV
JUSTIN METAL RIGATO ACC. TELA	My Way	CV
JUSTIN PRONTO STAMPA SEMPLICE	My Way	CCL
JUSTIN PYTON  LIGHT	My Way	CCL
JUSTIN PYTON TELA	My Way	CCL
JUSTIN QUEEN	My Way	CV
JUSTIN REPS	My Way	CCL
JUSTIN RESINATO	My Way	CCL
JUSTIN SCUBA	My Way	CV
JUSTIN SEMPLICE	My Way	CCL
JUSTIN SOFT	My Way	CCL
JUSTIN STEEL ACC REPS	My Way	CSP
JUSTIN STEEL ACC. LIGHT	My Way	CCL
JUSTIN STEEL ACC. TELA	My Way	CCL
JUSTIN STEEL ACC. TELA + LATTICIATURA EXPERT	My Way	
JUSTIN STEEL BOUCLE'	My Way	CCL
JUSTIN STEEL IN SEMPLICE	My Way	CCL
JUSTIN STEEL RESINATO	My Way	CCL
JUSTIN TELA	My Way	CCL
JUSTIN WASHED ACC. REPS	My Way	CV
JUTA DOPPIA LIGHT	Lange	CV
JUTA DOPPIA SEMPLICE	Lange	CV
JUTA DOPPIA TELA	Lange	CV
JUTA FLOWER ACC. LIGHT	Lange	CV
JUTA FLOWER SEMPLICE	Lange	CV
JUTA FLOWER TELA	Lange	CV
JUTA PEACH ACC LIGHT COLORATA	Lange	CE 11
JUTA PEACH ACC LIGHT VAR 3	Lange	CE 11
JUTA PEACH ACC TELA COLORATA	Lange	CE 11
JUTA PEACH ACC TELA VAR 3	Lange	CE 11
JUTA PEACH IN SEMPLICE COLORATA	Lange	CE 11
JUTA PEACH IN SEMPLICE VAR 3	Lange	CE 11
JUTA TELA DOPPIA RESINATA	Lange	CV
JUTALAND ACC. LIGHT	Lange	CCL
JUTALAND ACC. TELA	Lange	CCL
JUTALAND BIANCO ST VAR 2 RESINATA PER ETRO	Lange	CSP
JUTALAND IN SEMP+FINIS.IGNIFUGO PER CRIB 5	Lange	CV
JUTALAND IN SEMP+FINIS.IGNIFUGO+CIGAR	Lange	CV
JUTALAND IN SEMPLICE	Lange	CCL
JUTAN  LIGHT	Lange	CV
JUTAN  SEMPLICE	Lange	CV
JUTAN RESINATO	Lange	CV
JUTAN TELA	Lange	CV
JUTON	Pietro Mariani	CV
JUTUS ACC. LIGHT	Pietro Mariani	CV
JUTUS ACC. TELA	Pietro Mariani	CV
JUTUS RESINATO	Pietro Mariani	CV
JUTUS SEMPLICE	Pietro Mariani	CV
JUTUS SOFT	Pietro Mariani	CV
JUTUS TELA	Pietro Mariani	CV
JYBE LIGHT	Clementi	CV
JYBE SEMPLICE	Clementi	CV
JYBE TELA	Clementi	CV
KALIK BIANCO	Piave	CV
KALIK COLORATO	Piave	CV
KALIK NERO	Piave	CV
KAMBO	Piave	CV
KAMEO	Lange	CV
KANSAS ( WILD )	Griffine	CV
KANVAS REPS	Tessil Due	CV
KANVAS RESINATO	Tessil Due	CV
KANVAS SEMPLICE	Tessil Due	CV
KANVAS SOFT	Tessil Due	CV
KARIF	Taborelli	CV
KARIM ACC. LIGHT	Pietro Mariani	CCL
KARIM ACC. SOFT	Pietro Mariani	CCL
KARIM ACC. TELA	Pietro Mariani	CCL
KARIM IN SEMPLICE	Pietro Mariani	CCL
KARIM RESINATO	Pietro Mariani	CCL
KARLOS BIANCO	Lange	CCL
KARLOS COLORATO SEMPLICE	Lange	CSP
KARLOS COLORATO tela	Lange	CCL
KARLOS NERO	Lange	CCL
KARMAS ACC. LIGHT	Frigerio	CV
KARMAS ACC. TELA	Frigerio	CV
KARMAS IN SEMPLICE	Frigerio	CV
KARON COLORATI	Piave	CV
KARON RETE NERA	Piave	CV
KARON TUTTO BIANCO	Piave	CV
KARTIK	Lange	CV
KAY + LOFT	Piave	CCL
KAY COLORATO	Piave	CCL
KAY NERO	Piave	CCL
KELIS REPS	Ambiente Uomo	CV
KELIS SOFT	Ambiente Uomo	CV
KENAN	My Way	CV
KENNY ACC. LIGHT	Sitip	CCL
KENNY REPS	Sitip	CCL
KENNY RESINATO	Sitip	CCL
KENNY SEMPLICE	Sitip	CCL
KENNY SOFT	Sitip	CCL
KENNY TELA	Sitip	CCL
KENNY TELA - DBA	Mizar	CV
KENYON RESINATO	My Way	CV
KENYON SEMPLICE	My Way	CV
KENYON SOFT	My Way	CV
KENYON TELA	My Way	CV
KEOKI	Carvico	CV
KEOKY FLAG RETRO BIANCO	Carvico	CV
KEOKY FLAG RETRO COLORATO	Carvico	CV
KERMIT LIGHT	Taborelli	CV
KERMIT REPS	Taborelli	CV
KERMIT SEMPLICE	Taborelli	CV
KEVIN REPS	Gif	CV
KEVIN SEMPLICE	Gif	CV
KEVIN SOFT	Gif	CV
KEVIN SPALMATO	Gif	CV
KEY WEST ACC. LIGHT	Lange	CV
KEY WEST ACC. TELA	Lange	CV
KEY WEST IN SEMPLICE	Lange	CV
KHAKIS	Lange	CV
KIDD ACC. STRETCH	Griffine	CV
KIDD IN SEMPLICE	Griffine	CV
KIDD SEUDE ACC. LOFT MUNRO	Stilnovo	CV
KIDD SUEDE ACC. LIGHT MUNRO	Stilnovo	CV
KIDD SUEDE ACC. TELA MUNRO	Stilnovo	CV
KIDD SUEDE IN SEMPLICE MUNRO	Stilnovo	CV
KIDD SUEDE LEOPARD MUNRO ACC. LIGHT	Stilnovo	CV
KILMER	Lange	CV
KILT  ACC LIGHT+IDRO	Taborelli	CI 10/11
KILT  IN SEMPLICE	Taborelli	CI 10/11
KILT ACC REPS+IDRO	Taborelli	CI 10/11
KILT GLASS	Taborelli	
KILT STRETCH  ACC LIGHT	Taborelli	CI 10/11
KILT STRETCH  IN SEMPLICE	Taborelli	CI 10/11
KILT STRETCH ACC REPS	Taborelli	CI 10/11
KIMANI ACC. LIGHT	Taborelli	CV
KIMANI ACC. REPS	Taborelli	CV
KIMANI IN SEMPLICE	Taborelli	CV
KINGSTONE ACC. LIGHT	Uco	CV
KINGSTONE ACC. TELA	Uco	CV
KINGSTONE IN SEMPLICE	Uco	CV
KIRABO	Frigerio	CV
KIRAN	Corti	CV
KISHAN LIGHT	Ambiente Uomo	CV
KISHAN REPS	Ambiente Uomo	CV
KISHAN RESINATO	Ambiente Uomo	CV
KISHAN SEMPLICE	Ambiente Uomo	CV
KISHAN SOFT	Ambiente Uomo	CV
KISMET	Lange	CV
KITO	Beccalli	CV
KOBSON ACC. DENIM	Corti	CCL
KOBSON ACC. LIGHT	Corti	CCL
KOBSON ACC. OVATTA 80GR+ LIGHT	Corti	CV
KOBSON ACC.OVATTA 120 GR + LIGHT	Corti	CV
KOBSON EIR	Corti	CV
KOBSON IN SEMPLICE	Corti	CCL
KOBSON RESINATO	Corti	CCL
KOBSON SOFT	Corti	CCL
KOBSON TELA	Corti	CCL
KOBY	Taborelli	CV
KRAVIZ	Gif	CV
KROSBY STRETCH	Tat	CV
KUBRICK	Uco	CV
KUNI	Corti	CV
KUSUM	Piave	CV
KYKO + RESINA EUROFINISS X PRADA	Uboldi	CSP
KYKO ACC REPS + INK JET	Beccalli	CSP
KYKO ACC TELA + INK JET	Beccalli	CSP
KYKO ACC. TELA	Beccalli	CCL
KYKO ACC. TELA + LATTICIATURA EXPERT	Beccalli	
KYKO DENIM	Beccalli	CCL
KYKO LAVORAZIONE WHITE SPIRIT	Beccalli	
KYKO LIGHT	Beccalli	CCL
KYKO LUX ACC LIGHT	Beccalli	CCL
KYKO LUX ACC TELA	Beccalli	CCL
KYKO LUX IN SEMPLICE	Beccalli	CCL
KYKO PLISSE'	Beccalli	CV
KYKO POULE ACC. LIGHT	Beccalli	CV
KYKO POULE ACC. REPS	Beccalli	CV
KYKO PRONTO STAMPA SEMPLICE	Beccalli	CCL
KYKO PRONTO TINTA STAMPA TRANSFER DIS. CORONA	Beccalli	CV
KYKO REPS	Beccalli	CCL
KYKO REPS LAMINA STEEL	Beccalli	CV
KYKO REPS PRONTO TINTA	Beccalli	CCL
KYKO RESINATO	Beccalli	CCL
KYKO RESINATO EXPERT	Beccalli	CSP
KYKO RESINATO PRADA MT. 2000	Beccalli	
KYKO RESINATO PRADA MT.1000	Beccalli	
KYKO RESINTO OFFERTA PIU DI MILLE METRI	Beccalli	CSP
KYKO SEMPLICE	Beccalli	CCL
KYKO SOFT	Beccalli	CCL
KYKO STEEL ACC LIGHT	Beccalli	CE 11
KYKO STEEL ACC REPS	Beccalli	CE 11
KYKO STEEL IN SEMPLICE	Beccalli	CE 11
KYKO STEEL(VECCHIO) IN SEMPLICE	Beccalli	CE 11
KYKO SUBLITEX RESINATO	Beccalli	CV
KYKO UBOLDI RESINATO MICHAEL KORS	Uboldi	
KYLE	My Way	CV
KYRAN	Taborelli	CV
KYTE	Clerprem	CV
LACE STRETCH LIGHT	Taborelli	CI 11/12
LACE STRETCH LYCRA	Taborelli	CI 11/12
LACE STRETCH REPS	Taborelli	CI 11/12
LACE STRETCH SEMPLICE	Taborelli	CI 11/12
LACE WASHED LIGHT PE 12	Arianna pizzi	CE 12
LACE WASHED SEMPLICE PE 12	Arianna pizzi	CE 12
LACE WASHED TELA PE 12	Arianna pizzi	CE 12
LADY PASSION ART 80 ACC LIGHT	Taborelli	CI 10/11
LADY PASSION ART 80 ACC REPS	Taborelli	CI 10/11
LADY PASSION ART 80 IN SEMPLICE	Taborelli	CI 10/11
LADY PYTON ART 78 SOLO REPS	Taborelli	CI 10/11
LAMB ACC. LIGHT	Griffine	CCL
LAMB ACC. OVATTA CON LOFT	Griffine	CV
LAMB ACC. STRETCH FORATO IL FORO	Griffine	CV
LAMB CRINKLE ACC. LIGHT	Griffine	CV
LAMB CRINKLE ACC. LIGHT COLORATO	Griffine	CV
LAMB CRINKLE IN SEMPLICE	Griffine	CV
LAMB CRINKLE MORO/NERO IN SEMPLICE	Griffine	CV
LAMB IN SEMPLICE	Griffine	CCL
LAMB IN SEMPLICE FORATO IL FORO	Griffine	CV
LAMB QUEEN	Griffine	CCL
LAMB STRETCH	Griffine	CCL
LANA BOUCLE'	Taborelli	CSP
LANA BRISE' ACC REPS	Styletex	CI 11/12
LANA BRISE' LIGHT	Styletex	CI 11/12
LANA BRISE' SEMPLICE	Styletex	CI 11/12
LAPPON ACC. LIGHT	Taborelli	CV
LAPPON ACC. REPS	Taborelli	CV
LAPPON IN SEMPLICE	Taborelli	CV
LAURYN	Forma	CV
LEBRON IN SEMPLICE BASE BIANCO OTTICO	Lange	CV
LEBRON IN SEMPLICE BASE PRONTO TINTA	Lange	CV
LEBRON RESINATO BASE BIANCO OTTICO	Lange	CV
LEBRON RESINATO BASE PRONTO TINTA	Lange	CV
LEE	Heat Coat	CV
LEGEND ACC. LIGHT	Clementi	CV
LEGEND DELAVE LIGHT	Lange	CV
LEGEND DELAVE SEMPLICE	Lange	CV
LEGEND DELAVE TELA	Lange	CV
LEGEND SEMPLICE	Clementi	CV
LEGEND SOFT	Clementi	CV
LEGEND TELA	Clementi	CV
LEGENDARY ACC LIGHT	Italdenim	CE 10
LEGENDARY ACC TELA	Italdenim	CE 10
LEGENDARY IN SEMPLICE	Italdenim	CE 10
LEGENDARY IN SEMPLICE BASE JIMIX	Lange	
LEGENDARY VAR 1 SECRET BIANCO light	Italdenim	
LEGENDARY VAR 1 SECRET BIANCO SEMPLICE	Italdenim	CE 12
LEGENDARY VAR 1 SECRET BIANCO TELA	Italdenim	CE 12
LEMON	My Way	CCL
LEMON CHARMEUSE FERRAGAMO SEMPLICE	Dalmatex	CSP
LEMON REPS	Corti	CV
LEMON RESINATO	Corti	CV
LEMON SEMPLICE	Corti	CV
LEMON SOFT	Corti	CV
LENNOX VAR. 01 ARGENTO	Piave	CV
LENNOX VAR. 02 ORO	Piave	CV
LENNY	Forma	CV
LEO METAL ACC. LIGHT	Beccalli	CV
LEO METAL ACC. TELA	Beccalli	CV
LEO METAL IN SEMPLICE	Beccalli	CV
LEO REPS	Star	CV
LEO RESINATO	Star	CV
LEO SEMPLICE	Star	CV
LEO SOFT	Star	CV
LEO SUEDE ACC. LIGHT	Miti	CV
LEO SUEDE ACC. REPS	Miti	CV
LEO SUEDE IN SEMPLICE	Miti	CV
LEON	Miti	CV
LIGHT + LIGHT	Calosfil	CCL
LIGHT + LIGHT + AUTOADESIVO EXPERT	Carvico	CSP
LIGHT BIANCO + SOFT BIANCO	Riedel Textil	CSP
LIGHT NERO + SOFT NERO	Riedel Textil	CSP
LIGHT SUPERVERNICE	My Way	CSP
LIGHT+RESINA+IDRO	My Way	CSP
LIME ACC. LIGHT BIANCO	Saratex	CCL
LIME ACC. LIGHT COLORATO	Saratex	CCL
LIME ACC. TELA BIANCA	Saratex	CCL
LIME ACC. TELA COLORATI	Saratex	CCL
LIME IN SEMPLICE BIANCO	Saratex	CCL
LIME IN SEMPLICE COLORATO	Saratex	CCL
LINIUM ACC. TELA	Forma	CCL
LINIUM ACC.LIGHT	Forma	CCL
LINIUM REPS	Forma	CCL
LINIUM REPS FORATO	Forma	CV
LINIUM RESINATO	Forma	CCL
LINIUM SEMPLICE	Forma	CCL
LINIUM SOFT	Forma	CCL
LINO 100%  ACC. LIGHT	Forma	CCL
LINO 100% ACC. REPS	Forma	CCL
LINO 100% ACC. TELA	Forma	CCL
LINO 100% IN SEMPLICE	Forma	CCL
LINO 100% RESINATO	Forma	CCL
LINO 3 21 trame GUCCI RESINATO	Forma	CSP
LINO 3 GUCCI RESINATO+idro	Forma	CSP
LINO 5 GUCCI RESINATO	Forma	CSP
LINO 7 GUCCI RESINATO	Forma	CSP
LINO 9 RESINATO	Lange	CSP
LINO A +RESINA BEROFIN	My Way	CSP
LINO A RESINATO EXPERT	My Way	
LINO A STOCK 15000 MT + RESINA BEROFIN	My Way	CSP
LINO ACC. REPS FORATO	Forma	CV
LINO ACC. SOFT	Forma	CCL
LINO B      SEMPLICE CESTO+ENZIMI	Forma	CSP
LINO BENPHY RESINATO	Lange	CSP
LINO DOUBLE ACC. LIGHT	Forma	CCL
LINO DOUBLE ACC. TELA	Forma	CCL
LINO DOUBLE REPS	Forma	CCL
LINO DOUBLE RESINATO	Forma	CCL
LINO DOUBLE SEMPLICE	Forma	CCL
LINO DOUBLE SOFT	Forma	CCL
LINO FORMA RESINATO	Forma	CSP
LINO GUCCI FINITO RESINATO + DIRITTO FILO BEROFIN	Forma	
LINO GUCCI FINITO SEMPLICE	Forma	
LINO GUCCI GG RESINATO + DIRITTO FILO BEROFIN	Forma	
LINO GUCCI GG. IN SEMPLICE	Forma	
LINO MAGNUM ACC. LIGHT	Forma	CCL
LINO MAGNUM ACC. REPS	Forma	CCL
LINO MAGNUM ACC. SOFT	Forma	CCL
LINO MAGNUM ACC. TELA	Forma	CCL
LINO MAGNUM RESINATO	Forma	CCL
LINO MAGNUM SEMPLICE	Forma	CCL
LINO MELANGE RESINATO	Lange	CSP
LINUS REPS	Forma	CV
LINUS RESENATO	Forma	CV
LINUS SEMPLICE	Forma	CV
LINUS SOFT	Forma	CV
LIONEL	Miti	CV
LIONEL BIANCO	Miti	CV
LIONEL NERO	Miti	CV
LIZARD COLORATO IN SEMPLICE	My Way	CV
LIZARD IN SEMPLICE	My Way	CV
LIZARD METAL ACC. TELA COLORATA	My Way	CV
LIZARD METAL ACC. TELA ORO/ARGENTO	My Way	CV
LOFT + LOFT	Antares	CCL
LOFT + LOFT + AUTOADESIVO EXPERT	Riedel Textil	CV
LOGO FABRIC BURBERRYS ACC.PANAMA	Croserio	CSP
LOGOS LEMON	Italplastic	CCL
LOGOS LEMON FINO A MT. 150	Italplastic	
LOGOS REPS	Tessile Operati	CV
LOGOS REPS DOPPIA TINTURA	Donghi	CV
LOGOS RESINATO	Tessile Operati	CV
LOGOS RESINATO DOPPIA TINTURA	Donghi	CV
LOGOS SAND	Italplastic	CCL
LOGOS SOFT	Tessile Operati	CV
LOGOS SOFT DOPPIA TINTURA	Donghi	CV
LOGOS TELA	Tessile Operati	CV
LOLA LIGHT	Taborelli	CV
LOLA REPS	Taborelli	CV
LOLA SEMPLICE	Taborelli	CV
LONG CHAMP KYKO  STAMP. + P.CITY NERO IDRO	Beccalli	CSP
LONG CHAMP RASO  ST. + P.CITY COLORATO	My Way	CSP
LONG CHAMP RASO  STAMP. + P.CITY BIANCO	My Way	CSP
LONNY	Corti	CV
LOOP	Gif	CV
LOOP ACC. LIGHT COL.NERO	Corti	CV
LOOP ACC. LIGHT COLORATO	Corti	CV
LOOP ACC. TELA COL.NERO	Corti	CV
LOOP ACC. TELA COLORATO	Corti	CV
LOOP IN SEMPLICE COL.NERO	Corti	CV
LOOP IN SEMPLICE COLORATO	Corti	CV
LOOP LIGHT	Beccalli	CV
LOOP REPS	Beccalli	CV
LOOP SEMPLICE	Beccalli	CV
LOVE LACE LIGHT	Taborelli	CE 12
LOVE LACE REPS	Taborelli	CE 12
LOVE LACE SEMPLICE	Taborelli	CE 12
LUCA 1 ACC. REPS	Frigerio	CV
LUCA 2 ACC. REPS	Frigerio	CV
LUCA 3 ACC. REPS	Frigerio	CV
LUCA 4 ACC. REPS	Frigerio	CV
LUKE BIANCO	Miti	CV
LUKE COLORATO	Miti	CV
LUKE NERO	Miti	CV
LUREX FRIGERIO REPS 30 TRAME	Frigerio	CSP
LUXURY CANVAS ACC DENIM	Frigerio	CE 12
LUXURY CANVAS ACC REPS	Frigerio	CE 11
LUXURY CANVAS IN SEMPLICE	Frigerio	CE 11
LUXURY CANVAS/metal fluid  ACC LIGHT	Frigerio	CE 11
MACK ACC. LIGHT	Lange	CCL
MACK ACC. REPS	Lange	CCL
MACK ACC. TELA	Lange	CCL
MACK IN SEMPLICE	Lange	CCL
MACOULAGE ART 5 IN SEMPLICE	Taborelli	CI 10/11
MACOULAGE ART 5 LIGHT	Taborelli	CI 10/11
MACOULAGE ART 5 REPS	Taborelli	CI 10/11
MACRAME' FENDI APPRETTATO COLORATO E COL CAMPIONE	Ricamificio 2G	
MACRAME' FENDI APPRETTATO NERO-B.CO-NATURALE	Ricamificio 2G	CSP
MACRO CANVAS  ACC LIGHT	Lange	CE 11
MACRO CANVAS  ACC TELA	Lange	CE 11
MACRO CANVAS  IN SEMPLICE	Lange	CE 11
MACRO CANVAS VAR 2 ACC LIGHT	Lange	CE 11
MACRO CANVAS VAR 2 ACC TELA	Lange	CE 11
MACRO CANVAS VAR 2 IN SEMPLICE	Lange	CE 11
MACRO PANAMA ACC LIGHT	Lange	CE 11
MACRO PANAMA ACC TELA	Lange	CE 11
MACRO PANAMA CRINKLE	Lange	CE 11
MACRO PANAMA IN SEMPLICE	Lange	CE 11
MACY TELA	Uco	CV
MADDOX	Sitip	CV
MADISON	Clementi	CV
MADRAS ACC LIGHT BEROFIN+IDRO	Taborelli	CE 11
MADRAS ACC REPS BEROFIN+IDRO	Taborelli	CE 11
MADRAS IN SEMPLICE	Taborelli	CE 11
MAGIC ACC. REPS	Corti	CV
MAGIC ACC. TELA	Corti	CV
MAGIC IN SEMPLICE	Corti	CV
MAGIC LIGHT	Corti	CV
MAHIR ACC. LIGHT	Beccalli	CV
MAHIR ACC. REPS	Beccalli	CV
MAHIR IN SEMPLICE	Beccalli	CV
MAHIR RESINATO	Beccalli	CV
MAKAY	Lange	CV
MAKOSTONE  ACC LIGHT	Taborelli	CI 10/11
MAKOSTONE  CRINKLE IN SEMPLICE	Taborelli	CI 10/11
MAKOSTONE  CRINKLE LIGHT	Taborelli	CI 10/11
MAKOSTONE  IN SEMPLICE	Taborelli	CI 10/11
MAKOSTONE ACC REPS	Taborelli	CI 10/11
MALAGA GG.  LANGE + ACC. TELA	Lange	
MALIBU	Mariani cinese	CV
MAMBO LAMINA COLORATA	Croma srl	CV
MAMBO LAMINA ORO/ARGENTO	Croma srl	CV
MAMBO REPS	Ambiente Uomo	CV
MANO PESCA ACC. TELA	Caslino	CV
MARGARITA ACC. LIGHT COLORATI	My Way	CV
MARGARITA ACC. LIGHT ORO/ARGENTO	My Way	CV
MARGARITA ACC. REPS COLORATI	My Way	CV
MARGARITA ACC. REPS ORO/ARGENTO	My Way	CV
MARGARITA ACC. TEL A COLORATI	My Way	CV
MARGARITA ACC. TELA ORO/ARGENTO	My Way	CV
MARGARITA IN SEMPLICE  COLORATI	My Way	CV
MARGARITA IN SEMPLICE oro/argento	My Way	CV
MARLEY ACC TELA	Lange	CCL
MARLEY ACC TELA BRINATURA ORO SATINATO	Lange	CSP
MARLIN BIANCO	Piave	CV
MARLIN COLORATO	Piave	CV
MARLIN NERO	Piave	CV
MARLON ACC. LIGHT	My Way	CV
MARLON ACC. REPS	My Way	CV
MARLON IN SEMPLICE	My Way	CV
MARLON LYCRA V.1/2	Miti	CV
MARLON LYCRA V.3/4	Fillattice	CV
MARLON RESINATO	My Way	CV
MARLON SEMPLICE V.1/2	Miti	CV
MARLON SEMPLICE V.3/4	Fillattice	CV
MARLON TELA V.1/2	Miti	CV
MARLON TELA V.3/4	Fillattice	CV
MARSHALL	Namsan Technology	CV
MARTINA JERSEY D.25843 MONO V.	Luce	CV
MARVIN ACC. DENIM	Borgini	CV
MARVIN ACC. STRETCH	Borgini	CV
MARVIN IN SEMPLICE	Borgini	CV
MARVIS	Piave	CV
MARYLIN  NERO ACC. REPS	Beccalli	CV
MARYLIN BIANCO ACC. REPS	Beccalli	CV
MARYLIN COLORATO ACC. REPS	Beccalli	CV
MATRIX  SOFT	Lange	CV
MATRIX LIGHT	Lange	CV
MATRIX RESINATO	Lange	CV
MATRIX SEMPLICE	Lange	CV
MATRIX ST. TRAMONTANO JET RESINATO	Lange	CV
MATRIX STAMPA TRAMONTANO JET SOFT	Lange	CV
MATRIX STAMPA TRAMONTANO JET TELA	Lange	CV
MATRIX TELA	Lange	CV
MATRIX TRAMONTANO ST. QUADRO RESIN.	Lange	CV
MATRIX TRAMONTANO ST. QUADRO SOFT	Lange	CV
MATRIX TRAMONTANO ST. QUADRO TELA	Lange	CV
MAVERICK  VAR. BRONZO ACC. LIGHT	Corti	CCL
MAVERICK  VAR. BRONZO IN SEMPLICE	Corti	CCL
MAVERICK ACC. LIGHT	Corti	CCL
MAVERICK ACC. TELA	Corti	CCL
MAVERICK IN SEMPLICE	Corti	CCL
MAVERICK VAR. BRONZO ACC. TELA	Corti	CCL
MAXWELL ACC. DENIM	Tat	CV
MAXWELL ACC. DENIM BIANCO	Tat	CV
MAXWELL ACC. DENIM+IDRO BEROFIN TOD'S	Tat	CV
MAXWELL ACC. REPS	Tat	CV
MAXWELL LIGHT	Tat	CV
MAXWELL RESINATO	Tat	CV
MAXWELL SEMPLICE	Tat	CV
MAXWELL TELA  +  IDRO	Tat	CV
MAXWELL TELA SENZA IDRO	Tat	CV
MEHARI  ACC. TELA	Lange	CCL
MEHARI ACC. LIGHT	Lange	CCL
MEHARI IN SEMPLICE	Lange	CCL
MELANGE  SEMPLICE	Ripa	CSP
MELVIN	Piave	CV
MERCY	Carvico	CV
MERIDA ACC. LIGHT	My Way	CV
MERIDA ACC. REPS	My Way	CV
MERIDA IN SEMPLICE	My Way	CV
MESH GLITT  NERO	Miti	CV
MESH GLITT BIANCO	Miti	CV
MESH GLITT COLORATO	Miti	CV
MESH METAL COLORATI	Piave	CV
MESH METAL ORO ARGENTO	Piave	CV
METAL BASKET COLORATO	My Way	CV
METAL BASKET ORO /ARG	My Way	CV
METAL BAY LAMINA COLORATA	Lange	CCL
METAL BAY ORO/ARGENTO	Lange	CCL
METAL CORD ACC LIGHT	Lazzati	CE 11
METAL CORD ACC REPS	Lazzati	CE 11
METAL CORD IN SEMPLICE	Lazzati	CE 11
METAL DENIM LIGHT	Berto spa	CV
METAL DENIM SEMPLICE	Berto spa	CV
METAL DENIM TELA	Berto spa	CV
METAL FLUID/SILVER NIGHT DENIM + IDRO	Frigerio	CE 11
METAL FLUID/SILVER NIGHT LIGHT	Frigerio	CE 11
METAL FLUID/SILVER NIGHT SEMPLICE	Frigerio	CE 12
METAL ICE/PURE SILVER ACC DENIM+IDRO	Frigerio	CSP
METAL ICE/PURE SILVER ACC LIGHT	Frigerio	CE 11
METAL ICE/PURE SILVER SEMPLICE	Frigerio	CE 11
METAL MESH IN SEMPLICE	Valli	CCL
METAL PLIX ACC.LIGHT	Taborelli	CCL
METAL PLIX ACC.TELA	Taborelli	CCL
METAL PLIX IN SEMPLICE	Taborelli	CCL
METAL SEA IN SEMPLICE colorati	Gif	CV
METAL SEA IN SEMPLICE oro/argento	Gif	CV
METAL SKY ACC. REPS	Frigerio	CV
METAL SKY ACC.LIGHT	Frigerio	CV
METAL SKY IN SEMPLICE	Frigerio	CV
METAL SUN IN SEMPLICE	Taborelli	CCL
METAL VELVET ACC. LIGHTLAM. COLORATO	My Way	CV
METAL VELVET ACC. LIGHTLAM. ORO/ARGENTO	My Way	CV
METAL VELVET ACC. REPS LAMINA COLORATO	My Way	CV
METAL VELVET ACC. REPS LAMINA ORO/ARG.	My Way	CV
METAL VELVET IN SEMPLICE LAM. COLORATO	My Way	CV
METAL VELVET IN SEMPLICE LAM. ORO/ARGENTO	My Way	CV
METALLIC COLORATI	Sadun	CE 11
METALLIC SCURI METALLIZZATI	Sadun	CE 11
METALLIC STAMPATO GUCCI (DA 10 A 199 MQ)	Sadun	CSP
METALLIC STAMPATO GUCCI (OLTRE 200 MQ)	Sadun	CSP
METALLIC UNITO 2x1 (Rif.GUCCI)	Sadun	CSP
METRO IN SEMPLICE	Eurojersey	CV
METRO LOFT	Eurojersey	CV
METRO REPS	Eurojersey	CV
MICH/MITCH	Corti	CV
MICKEY	Lange	CV
MICRO CRINKLE ACC. LIGHT	Mariani cinese	CV
MICRO CRINKLE ACC. TELA	Mariani cinese	CV
MICRO CRINKLE IN SEMPLICE	Mariani cinese	CV
MICRO DOUBLE	Mariani cinese	CCL
MICRO DOUBLE COL. SCURI	Mariani cinese	CCL
MICRO GARDEN	Mariani cinese	CV
MICRO PYTON LYCRA BASE BIANCA	Mariani cinese	CV
MICRO PYTON LYCRA BASE TINTA	Mariani cinese	CV
MICRO PYTON REPS BASE BIANCA	Mariani cinese	CV
MICRO PYTON REPS BASE TINTA	Mariani cinese	CV
MICRO PYTON STRETCH BASE BIANCA	Mariani cinese	CV
MICRO PYTON STRETCH BASE TINTA	Mariani cinese	CV
MICRO SUEDE REPS COL. SCURI	Mariani cinese	CCL
MICRO SUEDE REPS COL.CHIARI	Mariani cinese	CCL
MICRO SUEDE REPS COL.SCURI	Mariani cinese	CCL
MICRO SUEDE STRETCH COL. CHIARI	Mariani cinese	CCL
MICRO SUEDE STRETCH COL. SCURI	Mariani cinese	CCL
MICRO WHITE	Mariani cinese	CV
MICROBLADE ACC. LIGHT	Mariani cinese	CV
MICROBLADE ACC. REPS	Mariani cinese	CV
MICRODOUBLE	Mariani cinese	CV
MICRODOUBLE DUMESTE	Mariani cinese	CV
MICROFUR	Mariani cinese	CI09/10
MICROMOORE	Mariani cinese	CSP
MICRONAPLAK	Giardini	CV
MICROSUEDE ACC. LIGHT	Mariani cinese	CCL
MICROSUEDE ACC. LIGHT LAV.KINDER POINT	Mariani cinese	CSP
MICROSUEDE ACC. LIGHT- LELIEVRE	Mariani cinese	CSP
MICROSUEDE ACC. LIGHT+ TEFLON LELIEVRE	Mariani cinese	CSP
MICROSUEDE ACC. LYCRA LAV.KINDER POINT	Mariani cinese	CSP
MICROSUEDE ACC. TELA BIANCA+MICROSUEDE	Mariani cinese	CSP
MICROSUEDE ACC. TELA NERA+MICROSUEDE	Mariani cinese	CSP
MICROSUEDE ACC.REPS LAV.KINDER POINT	Mariani cinese	CSP
MICROSUEDE COL. CHIARI ACC. OVATTA LOFT	Mariani cinese	CSP
MICROSUEDE COL. CHIARI PLISSE'	Mariani cinese	CV
MICROSUEDE COL. SCURI ACC. OVATTA LOFT	Mariani cinese	CV
MICROSUEDE COL. SCURI PLISSE'	Mariani cinese	CV
MICROSUEDE IN SEMPLICE + LAMINIA  3152	Mariani cinese	CV
MICROSUEDE IN SEMPLICE LELIEVRE	Mariani cinese	CV
MICROSUEDE LAMINATO TSQ LIGHT	Mariani cinese	CSP
MICROSUEDE LAMINATO TSQ REPS	Mariani cinese	CSP
MICROSUEDE LIGHT	Mariani cinese	CCL
MICROSUEDE LIGHT CHIARI	Mariani cinese	CCL
MICROSUEDE LIGHT LELIEVRE VIERRE	Mariani cinese	CSP
MICROSUEDE LYCRA	Mariani cinese	CCL
MICROSUEDE LYCRA COL. SCURI	Mariani cinese	CV
MICROSUEDE PLISSE'	Mariani cinese	
MICROSUEDE REPS	Mariani cinese	CCL
MICROSUEDE REPS LAV. STEEL	Mariani cinese	CV
MICROSUEDE RESINATO	Mariani cinese	CCL
MICROSUEDE RESINATO COL.CHIARI	Mariani cinese	CCL
MICROSUEDE SEMPLICE	Mariani cinese	CCL
MICROSUEDE SEMPLICE BOUCLE'	Mariani cinese	CV
MICROSUEDE SEMPLICE COL.SCURI	Mariani cinese	CCL
MICROSUEDE SEMPLICE LELIEVRE VIERRE	Mariani cinese	CSP
MICROSUEDE SOFT	Mariani cinese	CCL
MICROSUEDE TELA	Mariani cinese	CCL
MICROSUEDE TELA CHIARI	Mariani cinese	CCL
MICROSUEDE TINTO + IDRO PER LANCEL	Mariani cinese	
MICROVEGETAL LYCRA	Mariani cinese	CV
MICROVEGETAL REPS	Mariani cinese	CV
MICROVEGETAL RESINATO	Mariani cinese	CV
MICROVEGETAL SEMPLICE	Mariani cinese	CV
MICROVEGETAL TELA	Mariani cinese	CV
MIKEY	Toia	CV
MILES  SEMPLICE	Mariani cinese	CV
MILES LOFT	Mariani cinese	CV
MILES REPS	Mariani cinese	CV
MILES TELA	Mariani cinese	CV
MILLER	Corti	CV
MIMETICO COT/LINO RESINATO	Lange	CV
MIMETICO COT/LINO SOFT	Lange	CV
MIMETICO COT/LINO TELA	Lange	CV
MIMETICO DENIM GG RESINATO	Clementi	CV
MIMETICO DENIM GG SOFT	Clementi	CV
MIMETICO DENIM GG TELA	Clementi	CV
MINI JIMIX GREGGIO SEMPLICE	Lange	CSP
MINI JIMIX ottico/p.tinta semplice	Lange	CSP
MISTRAL	Beccalli	CV
MISTRAL IN SEMPLICE	Beccalli	CV
MISTRAL REPS	Beccalli	CV
MISTRAL SOFT	Beccalli	CV
MITCH	Mariani cinese	CV
MITCHELL	Forma	CV
MOBLEY	Tat	CV
MOBY DENIM	Eurojersey	CV
MOBY LYCRA	Eurojersey	CV
MOBY SEMPLICE	Eurojersey	CV
MOBY SPALMATO	Eurojersey	CV
MOJO	Fillattice	CV
MONKY	My Way	CV
MONTEREY ACC. LIGHT	Taborelli	CV
MONTEREY ACC. REPS	Taborelli	CV
MONTEREY ACC. TELA	Taborelli	CV
MONTEREY IN SEMPLICE	Taborelli	CV
MOOD IN SEMPLICE	Erco Pizzi	CV
MOOLLY ACC. LIGHT	Ermapel	CV
MOOLLY ACC. TELA	Ermapel	CV
MOOLLY IN SEMPLICE	Ermapel	CV
MOON (KYKO POIS LIGHT)	Beccalli	CV
MOON (KYKO POIS REPS)	Beccalli	CV
MOORE	Furpile	
MOORE (vecchio) IN SEMPLICE	My Way	CV
MORGAN RESINATO	Pietro Mariani	CV
MORGAN SEMPLICE	Pietro Mariani	CV
MORGAN SOFT	Pietro Mariani	CV
MORGAN TELA	Pietro Mariani	CV
MORRIS ACC. LIGHT VAR.1/3	Forma	CV
MORRIS ACC. LIGHT VAR.2	Forma	CV
MORRIS ACC. TELA VAR.1/3	Forma	CV
MORRIS ACC. TELA VAR.2	Forma	CV
MORRIS IN SEMPLICE VAR.1/3	Forma	CV
MORRIS IN SEMPLICE VAR.2	Forma	CV
MORRIS2	Corti	CV
MORRISON + JIMIX	Berto spa	CV
MORRISON ACC. TELA	Berto spa	CV
MORRISON IN SEMPLICE	Berto spa	CV
MORRISON IN SEMPLICE DELAVATO	Berto spa	CV
MOSES RUBEN LYCRA	Fillattice	CV
MOSES RUBEN SEMPLICE	Fillattice	CV
MOSES RUBEN TELA	Fillattice	CV
MOSES WALKER LYCRA	Miti	CV
MOSES WALKER SEMPLICE	Miti	CV
MOSES WALKER TELA	Miti	CV
MOSES WALLY LYCRA	Piave	CV
MOSES WALLY SEMPLICE	Piave	CV
MOSES WALLY TELA	Piave	CV
MOTIF ACC. LIGHT	Taborelli	CV
MOTIF ACC. TELA	Taborelli	CV
MOTIF IN SEMPLICE	Taborelli	CV
MOTION	Beccalli	CV
MOTOWN ACC. REPS NO IDRO BEROFIN	My Way	CV
MOUSE	Griffine	CV
MOUSE ACC. STRETCH	Griffine	CV
MOUSE ACC. TELA	Griffine	CV
MUSA	Croma srl	CV
MYKONOS RESINATO	Texal	CV
MYKONOS SOFT	Texal	CV
MYKONOS TELA	Texal	CV
MYLES ACC. LIGHT	Lange	CV
MYLES ACC. TELA	Lange	CV
MYLES IN SEMPLICE	Lange	CV
MYMETIC WOOL CRINKLE	Taborelli	CI 11/12
MYMETIC WOOL CRINKLE LIGHT	Taborelli	CI 11/12
MYMETIC WOOL IN SEMPLICE	Taborelli	CI 11/12
MYMETIC WOOL LIGHT	Taborelli	CI 11/12
MYMETIC WOOL REPS	Taborelli	
MYSTIC ACC. LIGHT	Taborelli	CCL
MYSTIC ACC. REPS	Taborelli	CCL
MYSTIC IN SEMPLICE	Taborelli	CCL
NAIS ACC. LIGHT	Lange	CV
NAIS ACC. TELA	Lange	CV
NAIS IN SEMPLICE	Lange	CV
NAJILA LIGHT	Lange	CV
NAJILA RESINATO	Lange	CV
NAJILA SEMPLICE	Lange	CV
NAJILA TELA	Lange	CV
NAPAJI BIANCO	Carvico	CCL
NAPAJI COLORATI	Carvico	CCL
NAPAJI NERO	Carvico	CCL
NAPLES	Lange	CV
NAPPAMICRO	Giardini	CV
NASH REPS	Ambiente Uomo	CV
NASH SOFT	Ambiente Uomo	CV
NASTY BIANCO	Lange	CV
NASTY GREGGIO	Lange	CV
NASTY LIGHT	Lange	CV
NASTY SEMPLICE	Lange	CV
NASTY TELA	Lange	CV
NATAL RUBEN (wally max)	Fillattice	CV
NATAL WALKER	Miti	CV
NATAL WALLY	Piave	CV
NATURAL ART CRINKLE	Lange	CE 12
NATURAL ART CRINKLE LIGHT	Lange	CE 12
NATURAL ART LIGHT	Lange	CE 12
NATURAL ART SEMPLICE	Lange	CE 12
NATURAL ART TELA	Lange	CE 12
NATURAL BAY ACC. LIGHT	Lange	CV
NATURAL BAY ACC. TELA	Lange	CV
NATURAL BAY IN SEMPLICE	Lange	CV
NATURAL GREGGIO LIGHT	Lange	CV
NATURAL GREGGIO SEMPLICE	Lange	CV
NATURAL GREGGIO TELA	Lange	CV
NATURAL LACE SEMPLICE APPRETTATO PE 12	Ricamificio 2G	CE 12
NATURAL LIGHT BIANCO	Lange	CV
NATURAL LIGHT COLORATI	Lange	CV
NATURAL MESH SEMPLICE APPRETTATO PE 12	Pozzi	CE 12
NATURAL MESH SEMPLICE PE 12	Pozzi	CE 12
NATURAL SEMPLICE BIANCO	Lange	CV
NATURAL SEMPLICE colorati	Lange	CV
NATURAL SUN ACC. LIGHT	Lange	CV
NATURAL SUN ACC. TELA	Lange	CV
NATURAL SUN IN SEMPLICE	Lange	CV
NATURAL TELA BIANCO	Lange	CV
NATURAL TELA COLORATI	Lange	CV
NELSON DENIM X ACTION	Heat Coat	CV
NEOPREN FIVE	Eurojersey	CI 11/12
NEOPREN MESH	Piave	CI 11/12
NEOPREN NINE	Eurojersey	CI 11/12
NEOPRENE COLLEZIONE A/I	Eurojersey	CI 11/12
NEOPRENE NUOVO gucci	Eurojersey	CSP
NEOPRENE X GUCCI	Eurojersey	CSP
NEOPRENE X GUCCI INTERLOCK TINTO	Eurojersey	CSP
NETURAL LACE SEMPLICE  PE 12	Ricamificio 2G	CE 12
NEW CANVAS CERATO SEMPLICE	Lange	CSP
NEW DENIM ACC. LIGHT + IDRO	Berto spa	CV
NEW DENIM ACC. LIGHT V.2	Berto spa	CV
NEW DENIM ACC. SOFT VAR.2	Berto spa	CV
NEW DENIM ACC. TELA + IDRO	Berto spa	CV
NEW DENIM ACC. TELA V.2	Berto spa	CV
NEW DENIM DELAVATO ACC. LIGHT	Berto spa	CV
NEW DENIM DELAVATO ACC. LIGHT + IDRO	Berto spa	CV
NEW DENIM DELAVATO ACC. SOFT	Berto spa	CV
NEW DENIM DELAVATO ACC. TELA	Berto spa	CV
NEW DENIM DELAVATO ACC. TELA + IDRO	Berto spa	CV
NEW DENIM DELAVATO IN SEMPLICE	Berto spa	CV
NEW DENIM IN SEMPLICE V.2	Berto spa	CV
NEW JACK	My Way	CV
NEW KUMQUAT ACC. LIGHT	Tat	CCL
NEW KUMQUAT DENIM	Tat	CCL
NEW KUMQUAT PRONTO STAMPA SEMPLICE	Tat	CCL
NEW KUMQUAT PRONTO TINTA TERMOFISS.	Tat	CSP
NEW KUMQUAT REPS	Tat	CCL
NEW KUMQUAT RESINATO	Tat	CCL
NEW KUMQUAT SCUBA	Tat	CCL
NEW KUMQUAT SEMPLICE	Tat	CCL
NEW KUMQUAT STRETCH	Tat	CCL
NEW KUMQUAT TELA	Tat	CCL
NEW LINGOT DENIM	Tat	CCL
NEW LINGOT REPS	Tat	CCL
NEW LINGOT SEMPLICE	Tat	CCL
NEW LINGOT stretch	Tat	CCL
NEW SEVENTY ACC. SOFT	Sanesi	CV
NEW SEVENTY LIGHT	Sanesi	CV
NEW SEVENTY REPS	Sanesi	CV
NEW SEVENTY RESINATO	Sanesi	CV
NEW SEVENTY SEMPLICE	Sanesi	CV
NEW SEVENTY TELA	Sanesi	CV
NEW STREET TECH ACC. LIGHT	Corti	CCL
NEW STREET TECH ACC.LIGHT+IDRO	Corti	CSP
NEW STREET TECH ACC.TELA	Corti	CCL
NEW STREET TECH ACC.TELA+IDRO	Corti	CSP
NEW STREET TECH IN SEMPLICE	Corti	CCL
NEW STREET TECH SEMPLICE + IDRO	Corti	CSP
NEW WASHED	Lange	CV
NEWPORT ACC LIGHT	Corti	CSP
NEWPORT ACC OVATTA 80 GR	Corti	CSP
NEWPORT ACC.  LIGHT + IDRO	Corti	CCL
NEWPORT ACC. REPS BEROFIN	Corti	CCL
NEWPORT ICEBERG	Corti	CSP
NEWPORT IN SEMPLICE	Corti	CCL
NEWPORT NUOVA RESINA PROVA 1	Corti	
NEWPORT NUOVA RESINA PROVA 2	Corti	CSP
NEWPORT REPS	Corti	CCL
NEWPORT RESINATO	Corti	CCL
NEWPORT RESINATO + IDRO	Corti	CV
NEWPORT RESINATO BIANCO OTTICO	Corti	CV
NEWPORT SCHIUMATO BETA	Corti	CV
NEWPORT SCUBA	Corti	CV
NEWPORT SOFT BEROFIN BIANCO	Corti	CCL
NEWPORT SOFT BEROFIN NERO	Corti	CCL
NIGHT FLOWER light	Arianna pizzi	CI 11/12
NIGHT FLOWER REPS	Arianna pizzi	CI 11/12
NIGHT FLOWER SEMPLICE	Arianna pizzi	CI 11/12
NIGHT LACE light	Taborelli	CE 12
NIGHT LACE REPS	Taborelli	CE 12
NIGHT LACE SEMPLICE	Taborelli	CE 12
NIKKI  RESINATO	Lange	CV
NIKKI ACC. DENIM + TEFLON	Lange	CV
NIKKI ACC. LIGHT	Lange	CV
NIKKI ACC.TELA	Lange	CV
NIKKI IN SEMPLICE	Lange	CV
NIKS IN SEMPLICE	Corti	CV
NIKS RESINATO	Corti	CV
NIKS SOFT	Corti	CV
NIKS TELA	Corti	CV
NILTON	Miti	CV
NILTON BIANCO	Miti	CV
NILTON NERO	Miti	CV
NINA DEL MAR ACC. LIGHT	My Way	CV
NINA DEL MAR ACC. REPS	My Way	CV
NINA DEL MAR ACC. TELA	My Way	CV
NINA DEL MAR IN SEMPLICE	My Way	CV
NISHA	Taborelli	CV
NOA	Corti	CV
NOAH	Mariani cinese	CV
NOKAI	Ambiente Uomo	CV
NOLITA	My Way	CV
NOMAD LIGHT	Mariani cinese	CV
NOMAD REPS	Mariani cinese	CV
NOMAD RESINATO	Mariani cinese	CV
NOMAD SEMPLICE	Mariani cinese	CV
NORTON LIGHT	Lazzati	CI 11/12
NORTON REPS	Lazzati	CI 11/12
NORTON SEMPLICE	Lazzati	CI 11/12
NOTTURNO 1-2 BORGINI STAMPATO PER FENDI	Borgini	
NOTTURNO 3- 4 ANTARES STAMPATO PER FENDI	Antares	CSP
NUOVO ART WALLY+LYCRA+MTP+LYCRA	Piave	CSP
NUOVO KYKO UBOLDI IN SEMPLICE	Uboldi	CSP
nuovo raso elastico my way	My Way	CSP
NUOVO RICAMO COME HOT SKY  LIGHT COLORATO	Lange	CSP
NUOVO RICAMO COME HOT SKY  LIGHT VAR 2	Lange	CSP
NYLON PRADA PROT MENB IDRO MAGL NOSTRA	Corti	CV
NYLON PRADA PROTEC MENBRANA IDRO	Corti	CV
NYLON PRADAFOGLIA TRASP IDRO + INTERLOCK	Corti	CV
NYLON PROTEC STROPICCIATO	Corti	CV
NYLON PROTEC STROPICCIATO SOFT	Corti	CV
OAK	Tat	CV
OCEAN	Beccalli	CV
OIL CANVAS LIGHT	Lange	CI 11/12
OIL CANVAS sempl	Lange	CI 11/12
OIL CANVAS TELA	Lange	CI 11/12
OIL COTTON RESINATO	Gif	CV
OIL COTTON SEMPLICE	Gif	CV
OIL COTTON SOFT	Gif	CV
OIL COTTON TELA	Gif	CV
OIL MICROSTRETCH LIGHT	Mariani cinese	CI 10/11
OIL MICROSTRETCH REPS	Mariani cinese	CI 10/11
OIL MICROSTRETCH SEMPLICE	Mariani cinese	CI 10/11
OIL SATIN  ACC LIGHT	Radici Group	CI 10/11
OIL SATIN  ACC REPS	Radici Group	CI 10/11
OIL SATIN  IN SEMPLICE	Radici Group	CI 10/11
OIL SATIN CRINKLE	Radici Group	CI 10/11
OIL STONE	Corti	CI 10/11
OIL STONE  CRINKLE	Corti	CI 10/11
OIL TECH ART  51 ACC LIGHT	Corti	CI 10/11
OIL TECH ART  51 ACC REPS	Corti	CI 10/11
OIL TECH ART 51 IN SEMPLICE	Corti	CI 10/11
OIL VELOUR STRETCH ACC LIGHT	Ciemme	CI 10/11
OIL VELOUR STRETCH ACC LYCRA	Ciemme	CI 10/11
OIL VELOUR STRETCH ACC REPS	Ciemme	CI 10/11
OIL VELOUR STRETCH SEMPLICE	Ciemme	CI 10/11
OIL VELOUR STRETCH TINTO ACC LIGHT	Ciemme	CI 10/11
OIL VELOUR STRETCH TINTO ACC LYCRA	Ciemme	CI 10/11
OIL VELOUR STRETCH TINTO ACC REPS	Ciemme	CI 10/11
OIL VELOUR STRETCH TINTO IN SEMPLICE	Ciemme	CI 10/11
OKLEY SEMPLICE	Vision Land	CV
OKLEY SOFT	Vision Land	CV
OKLEY TELA	Vision Land	CV
OLD BAY ACC. LIGHT	Lange	CCL
OLD BAY ACC. TELA	Lange	CCL
OLD BAY IN SEMPLICE	Lange	CCL
OLD CERVO + GARDEN	Armac.com srl	CV
OLD DAINO ACC. LIGHT	Mariani cinese	CV
OLD DAINO ACC. REPS	Mariani cinese	CV
OLD MERINOS + GARDEN	Armac.com srl	CV
OLD SKIN ACC. LIGHT	Armac.com srl	CV
OLD SKIN ACC. REPS	Armac.com srl	CV
OLD SKIN IN SEMPLICE	Armac.com srl	CV
ONE SHOT ACC LIGHT	Sitip	CI09/10
ONE SHOT ACC REPS	Sitip	CI09/10
ONE SHOT IN SEMPLICE	Sitip	CI09/10
ORANGE BAY ACC. LIGHT	Lange	CCL
ORANGE BAY ACC. TELA	Lange	CCL
ORANGE BAY IN SEMPLICE	Lange	CCL
ORANGE DENIM	Taiana	CV
ORANGE SKY	Radici Group	CCL
ORANGE STRETCH	Taiana	CV
ORANGE SUN ACC. LIGHT colorati	Beccalli	CV
ORANGE SUN ACC. LIGHT oro/argento	Beccalli	CV
ORANGE SUN ACC. REPS colorati	Beccalli	CV
ORANGE SUN ACC. TELA  colorati	Beccalli	CV
ORANGE SUN IN SEMPLICE colorati	Beccalli	CV
ORANGE SUN IN SEMPLICE oro/argento	Beccalli	CV
ORANGIN ACC. LOFT	Tat	CV
ORANGIN ACC. REPS	Tat	CV
ORANGIN IN SEMPLICE	Tat	CV
OREGON	Coronet	CV
ORTIZ BIANCO	Lange	CV
ORTIZ COLORATO + TELA COLORATA	Lange	CV
ORTIZ GREGGIO	Lange	CV
ORTIZ LIGHT	Lange	CV
ORTIZ PRONTO T. ACC. TELA COLORATA	Lange	CV
ORTIZ SANFORIZZATO	Lange	CV
ORTIZ SEMPLICE	Lange	CV
ORTIZ TELA	Lange	CV
ORWELL ACC.LIGHT	Taborelli	CCL
ORWELL ACC.TELA	Taborelli	CCL
ORWELL IN SEMPLICE	Taborelli	CCL
ORWELL METAL ACC LIGHT	Taborelli	CV
ORWELL METAL ACC TELA	Taborelli	CV
ORWELL METAL IN SEMPLICE	Taborelli	CV
OSCAR RUBEN (wally max)	Fillattice	CV
OSCAR WALKER	Miti	CV
OSCAR WALLY	Piave	CV
OTIS	Lange	CV
OUTLINE	Redaelli	CV
OUTRAGE	Sat idea	CV
OVERLAND	Ambiente Uomo	CV
OWEN IN SEMPLICE	Corti	CV
OWEN LIGHT	Corti	CV
OWEN RESINATO	Corti	CV
OWEN SOFT	Corti	CV
OWEN TELA	Corti	CV
PAISLEY DENIM ACC LIGHT	Lange	CE 11
PAISLEY DENIM ACC TELA	Lange	CE 11
PAISLEY DENIM IN SEMPLICE	Lange	CE 11
PAJE	Eurojersey	CSP
PAJE INTERLOCK TINTO BEIGE	Eurojersey	CSP
PAJE' NUOVO DENIM/CHARMEUSE	Eurojersey	CSP
PAJE' NUOVO DENIM/CHARMEUSE FORATO	Eurojersey	CSP
PAJE' TELA/INTERLOCK	Eurojersey	CSP
PALM BAY ACC TELA	Italdenim	CE 11
PALM BAY IN SEMPLICE	Italdenim	CE 11
PAN. CITY STAMP.MONO COLORE LIGHT.IDRO	Clementi	CV
PAN. CITY STAMP.MONO COLORE SEMP.IDRO	Clementi	CV
PAN.CITY STAMP.MONO COLORE TELA IDRO	Clementi	CV
PANAMA CITY  BIANCO  LAV. FELIX	Clementi	CSP
PANAMA CITY  BIANCO +.MTP 1MM + TELA	Clementi	CSP
PANAMA CITY  BIANCO RESINATO  + IDRO BEROFIN	Lange	
PANAMA CITY + PAN.C. NERO	Clementi	CV
PANAMA CITY ACC. MAGLINA IDRO	Clementi	CV
PANAMA CITY ACC.LIGHT		CCL
PANAMA CITY BIANCA ACC. TELA FORATA	Lange	CV
PANAMA CITY BIANCO + P.C. BIANCO	Clementi	CV
PANAMA CITY BIANCO ACC. LIGHT	Lange	CCL
PANAMA CITY BIANCO RESINATO	Lange	CCL
PANAMA CITY BIANCO SEMPLICE	Lange	CCL
PANAMA CITY BIANCO SOFT	Lange	CCL
PANAMA CITY BIANCO TELA	Lange	CCL
PANAMA CITY COL. +  P.C. BIANCO	Clementi	CV
PANAMA CITY COL. + P.C. COL.	Clementi	CV
PANAMA CITY COLORATA ACC. TELA FORATA	Lange	CV
PANAMA CITY COLORATO + MTP 1MM ACC TELA	Clementi	CV
PANAMA CITY COLORATO ACC. LIGHT	Lange	CCL
PANAMA CITY COLORATO ACC.TELA	Lange	CCL
PANAMA CITY COLORATO IN SEMPLICE	Lange	CCL
PANAMA CITY COLORATO LAV. FELIX	Clementi	CSP
PANAMA CITY COLORATO RESINATO	Lange	CCL
PANAMA CITY COLORATO RESINATO + IDRO BEROFIN	Lange	
PANAMA CITY COLORATO SOFT	Lange	CCL
PANAMA CITY D. CROCE LUCE TELA	Clementi	CV
PANAMA CITY D. CROCE RESINATO	Clementi	CV
PANAMA CITY D. CROCE TELA	Clementi	CV
PANAMA CITY D.CROCE  SEMPLICE	Clementi	CV
PANAMA CITY D.CROCE LIGHT	Clementi	CV
PANAMA CITY NERO + P.C. NERO	Clementi	CV
PANAMA CITY NERO + PAN.C. BIANCO	Clementi	CV
PANAMA CITY NERO ACC. TELA FORATA	Lange	CV
PANAMA CITY NERO LAV. FELIX	Clementi	CV
PANAMA CITY NERO LIGHT	Lange	CCL
PANAMA CITY NERO RESINATO	Lange	CCL
PANAMA CITY NERO RESINATO  IDRO	Lange	CCL
PANAMA CITY NERO RESINATO + IDRO BEROFIN	Lange	
PANAMA CITY NERO SEMPLICE	Lange	CCL
PANAMA CITY NERO SOFT	Lange	CCL
PANAMA CITY NERO TELA	Lange	CCL
PANAMA CITY NERO+ MTP 1MM ACC. TELA	Clementi	CV
PANAMA CITY PVC TRASPARENTE	Clementi	CV
PANAMA CITY REATTIVO ignifugo	Clementi	CV
PANAMA CITY RESINATO BIANCO	Lange	CCL
PANAMA CITY RESINATO IDRO	Clementi	CCL
PANAMA CITY SEMPLICE BIANCO IDRO	Clementi	CCL
PANAMA CITY SEMPLICE IDRO	Clementi	CCL
PANAMA CITY SEMPLICE NERO IDRO	Clementi	CCL
PANAMA CITY SOFT	Clementi	CCL
PANAMA CITY TELA	Clementi	CCL
PANAMA STAMPATO PRINCIPE	Clementi	CV
PAPETE ACC. LIGHT colorati	Taborelli	CV
PAPETE ACC. LIGHT oro/argento	Taborelli	CV
PAPETE ACC.TELA colorati	Taborelli	CV
PAPETE ACC.TELA oro/argento	Taborelli	CV
PAPETE IN SEMPLICE colorati	Taborelli	CV
PAPETE IN SEMPLICE oro/argento	Taborelli	CV
PAPIRO BATICK IN SEMPLICE	My Way	CSP
PAPIRO BATICK REPS	My Way	CSP
PAPIRO BRINATO ACC REPS	My Way	CSP
PARADISE ACC. LIGHT	Taborelli	CV
PARADISE ACC. REPS	Taborelli	CV
PARADISE BAY ACC. LIGHT	Taborelli	CV
PARADISE BAY ACC. TELA	Taborelli	CV
PARADISE BAY ACC.REPS	Taborelli	CV
PARADISE BAY IN SEMPLICE	Taborelli	CV
PARADISE IN SEMPLICE	Taborelli	CV
PARADISE SENZA STRAPPO ACC. LIGHT	Taborelli	CV
PARADISE SENZA STRAPPO ACC.REPS	Taborelli	CV
PARADISE SENZA STRAPPO IN SEMPLICE	Taborelli	CV
PARISH	Miti	CV
PATCH	Namsan Technology	CV
PATCHWORK LEGGERO GUCCI NY 100%	Frigerio	CV
PATCHWORK PESANTE GUCCI NY 100%	Frigerio	CV
PATRICK ACC. LIGHT	Bossi	CV
PATRICK ACC. REPS BEROFIN	Bossi	CV
PATRICK IN SEMPLICE	Bossi	CV
PATRICK RESINATO	Bossi	CV
PAYTON COL.NERO	Corti	CV
PAYTON COLORATO	Corti	CV
PEACE IN SEMPLICE	Uco	CV
PEACE SOFT	Uco	CV
PEACE SPALMATO	Uco	CV
PEACE TELA	Uco	CV
PEACOCK REPS	Corti	CV
PEACOCK RESINATO	Corti	CV
PEACOCK SEMPLICE	Corti	CV
PEACOCK SOFT	Corti	CV
PEARL JAM ACC. LIGHT	Taborelli	CV
PEARL JAM ACC. REPS	Taborelli	CV
PEARL JAM IN SEMPLICE	Taborelli	CV
PEKINE SEMPLICE	Griffine	CV
PELKY	Taborelli	CV
PENN ACC. LIGHT	Lange	CV
PENN ACC. TELA	Lange	CV
PENN IN SEMPLICE	Lange	CV
PENNY FERRAGAMO RESINATA + IDRO	Taborelli	CSP
PENNY FERRAGAMO RESINATA +IDRO	Taborelli	CSP
PENNY IN SEMPLICE	Eurojersey	CV
PENNY LOFT	Eurojersey	CV
PENNY REPS	Eurojersey	CV
PEOPLE	Ningbo Richtex	CV
PEPPER LIGHT	Taborelli	CV
PEPPER REPS	Taborelli	CV
PEPPER SEMPLICE	Taborelli	CV
PERKINS LIGHT	Lazzati	CI 11/12
PERKINS SEMPLICE	Lazzati	CI 11/12
PERKINS TELA	Lazzati	CI 11/12
PERLAS ACC. LIGHT	My Way	CV
PERLAS ACC. REPS	My Way	CV
PERLAS IN SEMPLICE	My Way	CV
PERRY	Griffine	CV
PERRY COLORATO	Corti	CV
PERRY COLORE NERO	Corti	CV
PHANTOM IN SEMPLICE	Frigerio	CI 11/12
PHANTOM light	Frigerio	CI 11/12
PHANTOM REPS	Frigerio	CI 11/12
PHARAON ACC LIGHT	Beccalli	CE 11
PHARAON ACC REPS	Beccalli	CE 11
PHARAON IN SEMPLICE	Beccalli	CE 11
PHARAON TELA	Beccalli	CE 11
PHOENIX  ACC LIGHT	Corti	CE 10
PHOENIX  ACC TELA	Corti	CE 10
PHOENIX IN SEMPLICE	Corti	CE 10
PICCADILLY	Griffine	CV
PIERCE	Taborelli	CV
PIGMENT	My Way	CV
PIPER	Corti	CV
PISTONS BIANCO/NERO	Pozzi	CE 10
PISTONS COLORATO	Pozzi	CE 10
PISTONS COLORATO NO APPRETTO	Pozzi	CSP
PLAID ACC LIGHT+idro	Taborelli	CI09/10
PLAID ACC REPS+idro	Taborelli	CI09/10
PLAID GARZATO  RESINATO	Taborelli	CI 11/12
PLAID GARZATO IN SEMPLICE	Taborelli	CI 11/12
PLAID GARZATO LIGHT	Taborelli	CI 11/12
PLAID GARZATO REPS+idro	Taborelli	CI 11/12
PLAID GLASS	Taborelli	
PLAID RESINATO + DIRITTO FILI + IDRO	Taborelli	
PLAID SCUBA	Taborelli	CSP
PLAID SEMPLICE	Taborelli	CI09/10
PLANET	Taborelli	CV
PLATA ACC. TELA ORO/ARGENTO	My Way	CV
PLATA COLORATA ACC. TELA	My Way	CV
PLATAN	Piave	CV
PLATINUM ARGENTO ACC LIGHT	Corti	CCL
PLATINUM ARGENTO ACC TELA	Corti	CCL
PLATINUM ARGENTO IN SEMPLICE	Corti	CCL
PLATINUM COLORATI ACC LIGHT	Corti	CCL
PLATINUM COLORATI ACC TELA	Corti	CCL
PLATINUM COLORATI IN SEMPLICE	Corti	CCL
PLATINUM ORO SATINATO ACC LIGHT	Corti	CCL
PLATINUM ORO SATINATO ACC TELA	Corti	CCL
PLATINUM ORO SATINATO IN SEMPLICE	Corti	CCL
PLAY ACC. TELA	Corti	
PLAY SCUBA	Corti	CV
PLAYA ACC. LIGHT	Lange	CV
PLAYA ACC. TELA	Lange	CV
PLAYA IN SEMPLICE	Lange	CV
PLAYER ACC. LIGHT	Corti	CV
PLAYER REPS	Corti	CV
PLAYER REPS IDROREPELLENTE	Corti	CV
PLAYER RESINATO	Corti	CV
PLAYER SEMPLICE	Corti	CV
PLAYER SOFT	Corti	CV
PLAYER TELA	Corti	CV
PLAYER TELA IDROREPELLENTE	Corti	CV
PLAYGROUND + STAMPA BASSOTTO H & B	Corti	CSP
PLAYGROUND ACC. LIGHT	Corti	CCL
PLAYGROUND ACC. LIGHT+IDRO	Corti	CSP
PLAYGROUND CORTI DENIM BIANCO	Corti	CCL
PLAYGROUND CORTI DENIM NERO	Corti	CCL
PLAYGROUND DENIM BEROFIN	Corti	CCL
PLAYGROUND DENIM EXPERT	Corti	CCL
PLAYGROUND LAV. MASON ACC. TELA	Corti	CSP
PLAYGROUND MTP1 MM DENS.40	Corti	CV
PLAYGROUND REPS BEROFIN	Corti	CCL
PLAYGROUND REPS EXPERT	Corti	CCL
PLAYGROUND RESINA+IDRO	Corti	CSP
PLAYGROUND RESINATO	Corti	CCL
PLAYGROUND SEMPLICE	Corti	CCL
PLAYGROUND SOFT ABILINE	Corti	CCL
PLAYGROUND SOFT BEROFIN	Corti	CCL
PLAYGROUND SOFT SPECCHIO	Corti	CV
PLAYGROUND TELA  D.B.A.	Corti	CSP
PLAYGROUND TELA BEROFIN	Corti	CCL
PLAYGROUND TELA EXPERT	Corti	CCL
PLAYGROUND TELA SPECCHIO	Corti	CV
PLAYMAKER ACC LIGHT	Tat	CE 10
PLAYMAKER ACC TELA	Tat	CE 10
PLAYMAKER ACC. REPS	Tat	
PLAYMAKER IN SEMPLICE	Tat	CE 10
PLIXE ACC. LIGHT	Dalmatex	CV
PLIXE ACC. TELA	Dalmatex	CV
PLUME ACC DENIM	Radici Group	CSP
PLUME ACC LIGHT+idro	Radici Group	CCL
PLUME ACC OVATTA 60	Radici Group	CV
PLUME ACC TELA	Radici Group	CCL
PLUME BOUCLE'	Radici Group	CCL
PLUME IN SEMPLICE	Radici Group	CCL
PLUME SCUBA	Radici Group	
PLUME SNOW	Radici Group	
PLUME TRAPUNTA DIAMANTE 2	Radici Group	CSP
PLUME TRAPUNTATO DIAMANTE	Radici Group	CSP
PLUTOS	Piave	CV
POCHO ACC LIGHT	Lange	CCL
POCHO ACC TELA	Lange	CCL
POCHO IN SEMPLICE	Lange	CCL
POCHO TWEED LIGHT	Frigerio	CSP
POCHO TWEED REPS	Frigerio	CSP
POCHO TWEED SEMPLICE	Frigerio	CSP
POCHO TWEED TELA	Frigerio	CSP
POCHO VUITTON	Lange	CSP
POIS LIGHT	Beccalli	CV
POIS REPS	Beccalli	CV
POIS RESINATO	Beccalli	CV
POIS SEMPLICE	Beccalli	CV
POIS TELA	Beccalli	CV
POLIESTERE TEVIRA CAMPIONATURE GREGGIO	Corti	CSP
POLIESTERE TEVIRA CAMPIONATURE TINTO	Corti	CSP
POLIESTERE TEVIRA GREGGIO	Corti	
POLIESTERI TREVIRA IN SEMPLICE	Corti	CSP
PONCHO ACC. LIGHT LAM. ORO/ARG.	Taborelli	CV
PONCHO ACC. LIGHT LAMINA COLOR.	Taborelli	CV
PONCHO ACC. TELA LAMINA COLOR.	Taborelli	CV
PONCHO ACC. TELA LAMINA ORO/ARG.	Taborelli	CV
PONCHO IN SEMPLICE LAM. ORO/ARG.	Taborelli	CV
PONCHO IN SEMPLICE LAMINA COLOR.	Taborelli	CV
POOKY BIANCO/NERO	Fillattice	CV
POOKY COLORATI	Fillattice	CV
POPSY	Uco	CV
PORT LOUIS ACC LIGHT	Frigerio	CE 11
PORT LOUIS ACC TELA	Frigerio	CE 11
PORT LOUIS IN SEMPLICE	Frigerio	CE 11
PORT ORANGE ACC LIGHT BEROFIN	Taborelli	CE 11
PORT ORANGE ACC REPS BEROFIN	Taborelli	CE 11
PORT ORANGE IN SEMPLICE	Taborelli	CE 11
PORTER ACC. LIGHT	Lange	CCL
PORTER ACC. TELA	Lange	CCL
PORTER BASKET	Lange	CCL
PORTER IN SEMPLICE	Lange	CCL
PORTRAIT DENIM	Tat	CCL
PORTRAIT LOFT	Tat	CCL
PORTRAIT REPS	Tat	CCL
PORTRAIT SEMPLICE	Tat	CCL
POWER	Uco	CV
PREMIER DENIM DELAVATO IN SEMPLICE	Berto spa	CSP
PREMIER DENIM IN SEMPLICE	Berto spa	CSP
PRINCE	Fillattice	CV
PROJET	Heat Coat	CV
PROVA BALLY  REPS	Corti	CSP
PROVA BALLY  REPS 2	Corti	CSP
PROVA BALLY  RESINATO	Corti	CSP
PROVA BALLY  RESINATO 2	Corti	CSP
PROVA BALLY  SEMPLICE	Corti	CSP
PROVA BALLY  SEMPLICE 2	Corti	CSP
PROVA BALLY  SOFT	Corti	CSP
PROVA BALLY  SOFT 2	Corti	CSP
PROVA BRICS SPINA CORDURA LIGHT.IDRO	Corti	CSP
PROVA BRICS SPINA CORDURA SEMP.IDRO	Corti	CSP
PROVA BRICS SPINA CORDURA TELA.IDRO	Corti	CSP
PROVA BRICS SPINA LISCIO LIGHT.IDRO	Corti	CSP
PROVA BRICS SPINA LISCIO SEMP.IDRO	Corti	CSP
PROVA BRICS SPINA LISCIO TELA.IDRO	Corti	CSP
PROVA FODERA BRICS NERA RES.IDRO	Taborelli	CSP
PROVA MUNRO CREPE  ACC.LYCRA	Corti	CSP
PROVA MUNRO CREPE ACC.DENIM	Corti	CSP
PROVA PANAMA CITY POLLINI LIGHT	Clementi	CSP
PROVA PANAMA CITY POLLINI RESINATO	Clementi	CSP
PROVA PANAMA CITY POLLINI SEMPLICE	Clementi	CSP
PROVA PANAMA CITY POLLINI TELA	Clementi	CSP
PROVA PRADA TECLI ICEBERG	Corti	CSP
PUERTO DENIM ACC LIGHT	Frigerio	CE 11
PUERTO DENIM ACC TELA	Frigerio	CE 11
PUERTO DENIM BERTO ACC. LIGHT	Berto spa	CV
PUERTO DENIM BERTO ACC. LIGHT WASHED	Berto spa	CV
PUERTO DENIM BERTO ACC. TELA	Berto spa	CV
PUERTO DENIM BERTO ACC. TELA WASHED	Berto spa	CV
PUERTO DENIM BERTO IN SEMPLICE	Berto spa	CV
PUERTO DENIM BERTO IN SEMPLICE DELAVATO	Berto spa	CV
PUERTO DENIM IN SEMPLICE	Frigerio	CE 11
PUERTO JEANS ACC. LIGHT	Berto spa	CV
PUERTO JEANS ACC. LIGHT DELAVATO	Berto spa	CV
PUERTO JEANS ACC. TELA	Berto spa	CV
PUERTO JEANS ACC. TELA DELAVATO	Berto spa	CV
PUERTO JEANS IN SEMPLICE	Berto spa	CV
PUERTO JEANS IN SEMPLICE DELAVATO	Berto spa	CV
PUERTO JIMIX ACC. LIGHT COLORATO	Lange	CV
PUERTO JIMIX ACC. LIGHT oro/argento	Lange	CV
PUERTO JIMIX ACC. TELA  oro/argento	Lange	CV
PUERTO JIMIX ACC. TELA COLORATO	Lange	CV
PUERTO JIMIX IN SEMPLICE colorato	Lange	CV
PUERTO JIMIX IN SEMPLICE oro/argento	Lange	CV
PUERTO PAISLEY ACC LIGHT	Frigerio	CE 11
PUERTO PAISLEY ACC TELA	Frigerio	CE 11
PUERTO PAISLEY IN SEMPLICE	Frigerio	CE 11
PUK	Taborelli	CV
PUMAS BIANCO PRONTO TINTA	My Way	CV
PUMAS COLORATO	My Way	CV
PURE BLACK ACC LIGHT	Taborelli	CE 10
PURE BLACK ACC TELA	Taborelli	CE 10
PURE BLACK IN SEMPLICE	Taborelli	CE 10
PURE METAL LIGHT  PE 12	Frigerio	CE 12
PURE METAL REPS  PE 12	Frigerio	CE 12
PURE METAL SEMPLICE  PE 12	Frigerio	CE 12
PURE NIGHT LIGHT PE 12	Frigerio	CE 12
PURE NIGHT REPS PE 12	Frigerio	CE 12
PURE NIGHT SEMPLICE PE 12	Frigerio	CE 12
PYTON CINZ ACC  LIGHT	Frigerio	CCL
PYTON CINZ ACC TELA	Frigerio	CCL
PYTON CINZ IN SEMPLICE	Frigerio	CCL
PYTON KUMQUAT REPS	Tat	CV
PYTON KUMQUAT STRETCH	Tat	CV
PYTON MESH	Piave	CV
PYTON METAL SEMPLICE	Griffine	CV
PYTON METAL STRETCH	Griffine	CV
PYTON SATIN	Beccalli	CV
PYTON SATIN SOFT	Beccalli	CV
PYTON STRETCH ART 77 ACC LIGHT	Taborelli	CI 10/11
PYTON STRETCH ART 77 ACC REPS	Taborelli	CI 10/11
PYTON STRETCH ART 77 IN SEMPLICE	Taborelli	CI 10/11
PYTON TECH ACC LIGHT	Taborelli	CE 10
PYTON TECH ACC TELA	Taborelli	CE 10
PYTON TECH IN SEMPLICE	Taborelli	CE 10
PYTON VELVET ACC REPS	Namsan Technology	CI09/10
QUARRY	Lange	CV
QUAY	Di.Bi.Ci.	CV
QUIXO ACTIVE	Corti	CV
QUIXO DAVISON	Corti	CV
QUIXO KYKO	Beccalli	CV
QUIXO PLAYGROUND	Corti	CV
RAIDER  ACC LIGHT	Corti	CI 10/11
RAIDER  ACC REPS	Corti	CI 10/11
RAIDER  IN SEMPLICE	Corti	CI 10/11
RAJA ACC LIGHT	Taborelli	CI09/10
RAJA ACC LIGHT BEROFIN	Taborelli	CSP
RAJA ACC TELA	Taborelli	CI09/10
RAJA ACC. LIGHT + IDRO BEROFIN	Taborelli	
RAJA IN SEMPLICE	Taborelli	CI09/10
RAJA REPS	Taborelli	CI09/10
RAMON	Taborelli	CV
RANDY RESINATO	Lange	CV
RANDY SEMPLICE	Lange	CV
RANDY SOFT	Lange	CV
RANDY TELA	Lange	CV
RAPHAEL	Beccalli	CV
RAPTOR BIANCO/NERO	Pozzi	CE 10
RAPTOR COLORATO	Pozzi	CE 10
RASHEED	Piave	CV
RASO  LONG CHAMP TRANSFER	Lange	CV
RASO BRUSH ACC LIGHT	Beccalli	CSP
RASO BRUSH ACC REPS	Beccalli	CSP
RASO BRUSH ACC TELA	Beccalli	CSP
RASO BRUSH IN SEMPLICE	Beccalli	CSP
RASO COTONE PER PRADA RESINA EUROFINIS	Uboldi	CSP
RASO COTONE PER PRADA RESINATO BEROFIN	Uboldi	CSP
RASO COTONE PER PRADA semplice	Uboldi	CSP
RASO MAGITEX PERU ACC. LIGHT	Magitex	CV
RASO MAGITEX PERU ACC. LYCRA	Magitex	CV
RASO MAGITEX PERU REPS	Magitex	CV
RASO MAGITEX PERU SEMPLICE	Magitex	CV
RASO PERLA  PRONTO TINTA TRANSFER	Beccalli	CV
RASO WASHED ACC REPS	Beccalli	CI 10/11
RASO WASHED IN SEMPLICE	Beccalli	CSP
RASO WASHED LIGHT	Beccalli	CI 10/11
RASPOON  ACC.TELA	Lange	CV
RASPOON ACC. LIGHT	Lange	CV
RASPOON IN SEMPLICE	Lange	CV
RASUS LOFT	Tat	CV
RASUS REPS	Tat	CV
RASUS RESINATO	Tat	CV
RASUS SEMPLICE	Tat	CV
RAY SEMPLICE	Griffine	CV
RAY STRETCH	Griffine	CV
RAY TELA	Griffine	CV
REBEL	Corti	CV
RED BAY ACC MTP	My Way	CE 10
RED BAY ACC TELA	My Way	CCL
RED BAY IN SEMPLICE	My Way	CCL
RED BERRY	Radici Group	CCL
RED CARPET	Taborelli	CV
RED FLOWER + MTP	Pietro Mariani	CSP
RED FLOWER ACC LIGHT	Pietro Mariani	CE 10
RED FLOWER ACC TELA	Pietro Mariani	CE 10
RED FLOWER IN SEMPLICE	Pietro Mariani	CE 10
RED JAY ACC LIGHT	Dalmatex	CCL
RED JAY ACC TELA	Dalmatex	CCL
RED JAY IN SEMPLICE	Dalmatex	CCL
RED MAGIC	Radici Group	CI09/10
RED PAMPERO ACC LIGHT	Taborelli	CI09/10
RED PAMPERO ACC REPS	Taborelli	CI09/10
RED PAMPERO ACC. TELA	Taborelli	
RED PAMPERO IN SEMPLICE	Taborelli	CI09/10
RED PEPPER	Radici Group	CCL
RED SAND ACC LIGHT	Lange	CCL
RED SAND ACC TELA	Lange	CCL
RED SAND IN SEMPLICE	Lange	CCL
RED SAND RESINATO BEROFIN	Lange	
RED SKY	Radici Group	CCL
RED SUNSET	Pozzi	CE 10
RED SUNSET GUCCI	Pozzi	CSP
RED VELVET ACC LIGHT	Namsan Technology	CCL
RED VELVET ACC REPS	Namsan Technology	CCL
RED VELVET IN SEMPLICE	Namsan Technology	CCL
RED WIND ACC LIGHT	Italdenim	CE 10
RED WIND ACC TELA	Italdenim	CE 10
RED WIND CRINKLE	Italdenim	CE 10
RED WIND CRINKLE ACC LIGHT	Italdenim	CE 10
RED WIND FINISS. ANASTASIA ACC TELA	Italdenim	CSP
RED WIND IN SEMPLICE	Italdenim	CE 10
REEF	Tessile Operati	CV
REGGAE	Lange	CV
REGGY	Lange	CV
RENO	Corti	CV
RETE GROSSA PIAVE	Piave	CV
RETE JUTA	Croma srl	CV
RETE VALLI -  LONGCHAMP	Valli	
REVERSE	Carvico	CV
REVERSE CON RICO	Piave	CV
REVOLUTION DENIM	Eurojersey	CV
REVOLUTION LYCRA	Eurojersey	CV
RICO	Piave	CCL
RICO COLORI DA TINGERE	Piave	CSP
RICO LOFT	Piave	CCL
RICO REPS	Piave	CCL
RIGA PER BENDEL ACC LIGHT	Taborelli	CE 11
RIGA PER BENDEL ACC LIGHT SPIANATA	Taborelli	CE 11
RIGA PER BENDEL IN SEMPLICE	Taborelli	CSP
RIGA PER BENDEL IN SEMPLICE SPIANATA	Taborelli	CSP
RIOS ACC. LIGHT	Taborelli	CV
RIOS ACC. REPS	Taborelli	CV
RIOS IN SEMPLICE	Taborelli	CV
"RIP STOP ""D"" LIGHT + IDRO"	Corti	CSP
"RIP STOP ""D"" TELA + IDRO"	Corti	
"RIP STOP ""D""GUCCI  SEMPLICE"	Corti	CSP
RITA IN NATURA RESINATO	My Way	CSP
RIVER REPS	Forma	CV
RIVER SOFT	Forma	CV
ROBIN	Lange	CV
ROBINSON	Sat idea	CV
ROBISON	Corti	CV
ROCK	Lange	CV
ROCKET ACC. DENIM   NERO  + IDRO BEROFIN	Corti	CCL
ROCKET ACC. DENIM BIANCO + IDRO BEROFIN	Corti	CCL
ROCKET ACC. REPS	Corti	CCL
ROCKET ACC. REPS COL.NERO + IDRO BEROFIN	Corti	CCL
ROCKET ACC. REPS COLORATI + IDRO BEROFIN	Corti	CCL
ROCKET ACC.LIGHT	Corti	CCL
ROCKET IN SEMPLICE	Corti	CCL
ROCKET RESINATO	Corti	CCL
ROD	Gif	CV
RODNEY TELA	Lange	CV
RODNY RESINATO	Lange	CV
RODNY SEMPLICE	Lange	CV
RODNY SOFT	Lange	CV
ROLLER ACC. DENIM NERO	Corti	CSP
ROLLER ACC. LIGHT	Corti	CCL
ROLLER ACC. REPS	Corti	CCL
ROLLER ACC. REPS + IDRO BEROFIN	Corti	CSP
ROLLER ACC. TELA	Corti	CCL
ROLLER IN SEMPLICE	Corti	CCL
ROLLER TELA + OLUVELI	Corti	
ROLLING STONE LIGHT	Italdenim	CI 11/12
ROLLING STONE SEMPLICE	Italdenim	CI 11/12
ROLLING STONE TELA	Italdenim	CI 11/12
ROWAN RESINATO	Gif	CV
ROWAN SEMPLICE	Gif	CV
ROWAN SOFT	Gif	CV
ROWAN TELA	Gif	CV
RUBEN BIANCO/NERO	Fillattice	CV
RUBEN BIANCO/NERO + PEKINE	Fillattice	CV
RUBEN COLORATO	Fillattice	CV
RUBEN COLORATO + PEKINE	Fillattice	CV
RUBIO SOFT	Aresia	CV
RUBIO TELA	Aresia	CV
RUDY ACC. TELA	Taborelli	CV
RUDY LIGHT	Taborelli	CV
RUDY REPS	Taborelli	CV
RUDY SEMPLICE	Taborelli	CV
RUFUS	My Way	CCL
RUNNER ACC DENIM +IDRO	Corti	CSP
RUNNER ACC LIGHT	Corti	CE 12
RUNNER ACC REPS	Corti	CE 12
RUNNER IN SEMPLICE	Corti	CE 12
RUNNER tod's ACC DENIM	Corti	CE 12
RUSTY BIANCO LIGHT	Lange	CV
RUSTY BIANCO SEMPLICE	Lange	CV
RUSTY BIANCO TELA	Lange	CV
RUSTY GREGGIO LIGHT	Lange	CV
RUSTY GREGGIO SEMPLICE	Lange	CV
RUSTY GREGGIO TELA	Lange	CV
RUSTY LIGHT COLORATI	Lange	CV
RUSTY SCHIUMATO LAV.BETA	Lange	CV
RUSTY SEMPLICE COLORATI	Lange	CV
RUSTY TELA COLORATI	Lange	CV
RYAN	Griffine	CV
RYAN LOFT	Griffine	CV
RYLEY	Taborelli	CV
SABLE	Namsan Technology	CV
SADUN DENIM	Eurojersey	CV
SADUN STRETCH	Eurojersey	CV
SAFARI  ACC. TELA	Lange	CCL
SAFARI ACC. LIGHT	Lange	CCL
SAFARI IN SEMPLICE	Lange	CCL
SAFFY ACC. LIGHT	Taborelli	CV
SAFFY ACC. TELA	Taborelli	CV
SAFFY IN SEMPLICE	Taborelli	CV
SAFIR LOFT	Tat	CV
SAFIR SEMPLICE	Tat	CV
SALV	Corti	CV
SAMAKI	Vision Land	CV
SAMOA ACC. LIGHT COLORATO	Taborelli	CV
SAMOA ACC. LIGHT ORO/ARGENTO	Taborelli	CV
SAMOA ACC. TELA COLORATO	Taborelli	CV
SAMOA ACC. TELA ORO/ARGENTO	Taborelli	CV
SAMOA IN SEMPLICE COLORATO	Taborelli	CV
SAMOA IN SEMPLICE ORO/ARGENTO	Taborelli	CV
SAMURAI	Lange	CV
SAMURAI NON DELAVATO	Lange	CV
SAND BAY ACC DENIM	My Way	CI09/10
SAND BAY ACC LIGHT	My Way	CE 10
SAND BAY ACC TELA	My Way	CE 10
SAND BAY CRINKLE	My Way	CE 10
SAND BAY CRINKLE light	My Way	CE 10
SAND BAY IN SEMPLICE	My Way	
SAND BEACH ACC LIGHT	Taborelli	CCL
SAND BEACH ACC TELA	Taborelli	CCL
SAND BEACH IN SEMPLICE	Taborelli	CCL
SAND FLOWER SEMPLICE APPRETTATO PE 12	Ricamificio 2G	CE 12
SAND FLOWER SEMPLICE PE 12	Ricamificio 2G	CE 12
SAND METAL COLORATO	Piave	CV
SAND METAL ORO ARGENTO	Piave	CV
SAND SENSATION	Lange	CE 10
SAND SHIRT ACC. LIGHT	Taborelli	
SAND SHIRT ACC. REPS	Taborelli	
SAND SHIRT IN SEMPLICE	Taborelli	
SAND SHIRT RESINATO	Taborelli	CSP
SAND SKIN ACC LIGHT	My Way	CE 11
SAND SKIN ACC REPS	My Way	CE 11
SAND SKIN IN SEMPLICE	My Way	CE 11
SAND SUNSET CRINKLE	Lange	CE 12
SAND SUNSET CRINKLE LIGHT	Lange	CE 12
SAND SUNSET LIGHT	Lange	CE 12
SAND SUNSET SEMPLICE	Lange	CE 12
SAND SUNSET TELA	Lange	CE 12
SAND VELVET	My Way	CV
SANDED ACC LIGHT	My Way	CE 11
SANDED ACC REPS	My Way	CE 11
SANDED CRINKLE	My Way	CE 11
SANDED CRINKLE LIGHT	My Way	CE 11
SANDED IN SEMPLICE	My Way	CE 11
SANDY ACC. LIGHT	Uco	CV
SANDY ACC. TELA	Uco	CV
SANDY IN SEMPLICE	Uco	CV
SATIN LAME LIGHT	Beccalli	CSP
SATIN LAME REPS	Beccalli	CSP
SATIN LAME SEMPLICE	Beccalli	CSP
SATIN NINE ACC. LIGHT	Tat	CV
SATIN NINE ACC. LOFT	Tat	CV
SATIN NINE ACC. REPS	Tat	CV
SATIN NINE IN SEMPLICE	Tat	CV
SATIN ONE ACC. REPS	Tat	CCL
SATIN ONE ACC. REPS + IDRO	Tat	CCL
SATIN ONE ACC. TELA + IDRO	Tat	CCL
SATIN ONE ACC.LIGHT	Tat	CCL
SATIN ONE IN SEMPLICE	Tat	CCL
SATIN PARTY ACC LIGHT COLORATI	Tat	CV
SATIN PARTY ACC LIGHT NERO	Tat	CV
SATIN PARTY ACC TELA COLORATI	Tat	CV
SATIN PARTY ACC TELA NERO	Tat	CV
SATIN PARTY IN SEMPLICE COLORATI	Tat	CV
SATIN PARTY IN SEMPLICE NERO	Tat	CV
SATIN STRETCH	Eurojersey	CV
SATIN STRETCH  DENIM	Eurojersey	CV
SATIN STRETCH LARIO	Eurojersey	CV
SATIN STRETCH LIGHT	Eurojersey	CV
SATIN STRETCH LOFT	Eurojersey	CV
SATOSHI	Taborelli	CV
SAX	My Way	CV
SAYO	Ambiente Uomo	CV
SCARLET ACC. LIGHT	Namsan Technology	CV
SCARLET TELA	Namsan Technology	CV
SCARLET VECCHIO	My Way	CV
SCORPION BAY AC. LIGHT	Lange	CV
SCORPION BAY ACC. TELA	Lange	CV
SCORPION BAY IN SEMPLICE	Lange	CV
SCOTTISH  IN SEMPLICE	Bossi	CCL
SCOTTISH ACC LIGHT	Bossi	CCL
SCOTTISH ACC REPS	Bossi	CCL
SCOTTISH RESINATO + DIRITTO FILO	Bossi	CCL
SCREEN	Heat Coat	CV
SCUBA B&B	Sitip	CSP
SEAT INDIANA SEMPLICE	Ambiente Uomo	CV
SENSITIVE +LIGHT/LIGHT	Eurojersey	CSP
SENSUAL ACC. LIGHT	Taborelli	CV
SENSUAL ACC. REPS	Taborelli	CV
SENSUAL IN SEMPLICE	Taborelli	CV
SERATA  PRONTO STAMPA GREGGIO ACC LIGHT	Taborelli	CSP
SERATA + STAMPA TRANSFER	Taborelli	CSP
SERATA P.STAMPA SEMPLICE	Taborelli	
SERATA PRONTO STAMPA IN SEMPLICE	Taborelli	CSP
SETA CANGIANTE ACC.LIGHT	Ambiente Uomo	CCL
SETA CANGIANTE REPS	Ambiente Uomo	CCL
SETA CANGIANTE RESINATA	Ambiente Uomo	CCL
SETA CANGIANTE SEMPLICE	Ambiente Uomo	CCL
SETA CANGIANTE SOFT	Ambiente Uomo	CCL
SETA INDIANA ACC. LIGHT BIANCA NERA	Ambiente Uomo	CCL
SETA INDIANA BIANCA NERA SEMPLICE	Ambiente Uomo	CCL
SETA INDIANA LIGHT COLORATA	Ambiente Uomo	CCL
SETA INDIANA REPS BIANCA NERA	Ambiente Uomo	CCL
SETA INDIANA REPS COLORATA	Ambiente Uomo	CCL
SETA INDIANA RESINATA BIANCA NERA	Ambiente Uomo	CCL
SETA INDIANA RESINATA COLORATA	Ambiente Uomo	CCL
SETA INDIANA SEMPLICE COLORATA	Ambiente Uomo	CCL
SETA INDIANA SOFT	Ambiente Uomo	CCL
SETA INDIANA SOFT COLORATA	Ambiente Uomo	CCL
SETIAK ACC LIGHT	Dalmatex	CCL
SETIAK ACC REPS	Dalmatex	CCL
SETIAK IN SEMPLICE	Dalmatex	CCL
SEVENTY REPS	Sanesi	CV
SEVENTY SEMPLICE	Sanesi	CV
SEVENTY SOFT	Sanesi	CV
SEX LACE LIGHT	Beccalli	CE 12
SEX LACE REPS	Beccalli	CE 12
SEX LACE SEMPLICE	Beccalli	CE 12
SEX STRETCH ACC LIGHT	Taborelli	CI09/10
SEX STRETCH ACC LYCRA X TOD' S	Taborelli	CSP
SEX STRETCH ACC.REPS	Taborelli	CI09/10
SEX STRETCH ACC.REPS idro x tod s	Taborelli	CSP
SEX STRETCH IN SEMPLICE	Taborelli	CI09/10
SEX WAVE ACC LIGHT	Taborelli	CI09/10
SEX WAVE ACC TELA	Taborelli	CI09/10
SEX WAVE IN SEMPLICE	Taborelli	CI09/10
SEYMOUR ACC. LIGHT	Griffine	CI09/10
SEYMOUR IN SEMPLICE	Griffine	CI09/10
SHABBA	Lange	CV
SHABBA MONOCOLORE	Lange	CV
SHABBAZ	My Way	CV
SHADO LYCRA	Yong Tong	CV
SHADO REPS	Yong Tong	CV
SHADO RESINATO	Yong Tong	CV
SHADO SEMPLICE	Yong Tong	CV
SHAGGY	Cifra	CV
SHAKE	My Way	CV
SHAKIR	Gif	CV
SHAKIR ACC. LIGHT	Frigerio	CV
SHAKIR ACC. REPS	Frigerio	CV
SHAKIR IN SEMPLICE	Frigerio	CV
SHALIMAR ACC. LIGHT	Griffine	CI09/10
SHALIMAR IN SEMPLICE	Griffine	CI09/10
SHAMAL ACC. LIGHT	Dalmatex	CCL
SHAMAL ACC. TELA	Dalmatex	CCL
SHAMAL IN SEMPLICE	Dalmatex	CCL
SHAMAL PYTON ACC LIGHT	Dalmatex	CI09/10
SHAMAL PYTON ACC TELA	Dalmatex	CI09/10
SHAMAL PYTON IN SEMPLICE	Dalmatex	CI09/10
SHANE ACC. REPS ORO/ARGENTO	Piave	CV
SHANE ACC. TELA LAMINA COLORATA	Piave	CV
SHANE ACC. TELA ORO/ARGENTO	Piave	CV
SHANE ACC.REPS LAMINECOLORATE	Piave	CV
SHANE COLORATI	Piave	CV
SHANE ORO ARGENTO	Piave	CV
SHANT METAL ACC. LIGHT	Taborelli	CV
SHANT METAL ACC.REPS	Taborelli	CV
SHANT METAL IN SEMPLICE	Taborelli	CV
SHANTE' ACC. LIGHT	Taborelli	CV
SHANTE' ACC. REPS	Taborelli	CV
SHANTE' IN SEMPLICE	Taborelli	CV
SHARIF REPS	Ambiente Uomo	CV
SHARIF RESINATO	Ambiente Uomo	CV
SHARIF SEMPLICE	Ambiente Uomo	CV
SHARIF SOFT	Ambiente Uomo	CV
SHARKAN LIGHT	Perlini	CV
SHARKAN REPS	Perlini	CV
SHARKAN RESINATO	Perlini	CV
SHARKAN SEMPLICE	Perlini	CV
SHELTER	Lange	CV
SHERMAN ACC.  TELA	Corti	CI09/10
SHERMAN ACC. LIGHT	Corti	CI09/10
SHERMAN IN SEMPLICE	Corti	CI09/10
SHERMAN SEMPLICE - VECCHIO	Griffine	CV
SHERMAN STRETCH - VECCHIO	Griffine	CV
SHERMAN TELA - VECCHIO	Griffine	CV
SHIMMER ACC LIGHT	Frigerio	CE 11
SHIMMER ACC REPS	Frigerio	CE 11
SHIMMER IN SEMPLICE	Frigerio	CE 11
SHIRT DENIM ACC LIGHT	Taborelli	CE 11
SHIRT DENIM ACC TELA	Taborelli	CE 11
SHIRT DENIM IN SEMPLICE	Taborelli	CE 11
SHOOT LIGHT	Taborelli	CV
SHOOT RESINATO	Taborelli	CV
SHOOT SEMPLICE	Taborelli	CV
SHOOT TELA	Taborelli	CV
SHORTER REPS	Toia	CV
SHORTER SEMPLICE	Toia	CV
SHORTER SOFT	Toia	CV
SHORTER SPALMATO	Toia	CV
SHORTY LIGHT	Clementi	CV
SHORTY SEMPLICE	Clementi	CV
SHORTY TELA	Clementi	CV
SHUGA LOFT	Tat	CV
SHUGA REPS	Tat	CV
SHUGA RESINATO	Tat	CV
SHUGA SEMPLICE	Tat	CV
SIDNEY	Corti	CV
SILK LAND REPS	Ambiente Uomo	CV
SILK LAND RESINATO	Ambiente Uomo	CV
SILK LAND SEMPLICE	Ambiente Uomo	CV
SILK LAND SOFT	Ambiente Uomo	CV
SILK STRETCH	Tat	CV
SILK STRETCH ACC. LIGHT	Tat	CV
SILK STRETCH DENIM	Tat	CV
SILK STRETCH LIGHT BREMBO	Tat	CV
SILK STRETCH LIGHT OVATTA GLOVE	Tat	CV
SILK STRETCH LYCRA	Tat	CV
SILK SUEDE LYCRA	Mariani cinese	CV
SILK SUEDE REPS	Mariani cinese	CV
SILK SUEDE RESINATO	Mariani cinese	CV
SILK SUEDE SEMPLICE	Mariani cinese	CV
SILKUS REPS	Tessil Due	CV
SILKUS RESINATO	Tessil Due	CV
SILKUS SEMPLICE	Tessil Due	CV
SILKUS SOFT	Tessil Due	CV
SILKY	Ambiente Uomo	CV
SILVER BABY	Croma srl	CV
SILVER CHRONO         PE 12	Heat Coat	CE 12
SILVER CORAL ACC. LIGHT COLORATI	Sat idea	CV
SILVER CORAL ACC. LIGHT ORO/ARGENTO	Sat idea	CV
SILVER CORAL ACC. REPS  COLORATI	Sat idea	CV
SILVER CORAL ACC. REPS ORO/ARGENTO	Sat idea	CV
SILVER CORAL IN SEMPLICE colorati	Sat idea	CV
SILVER CORAL IN SEMPLICE oro/argento	Sat idea	CV
SILVER COTTON IN SEMPLICE colorati	Lange	CV
SILVER COTTON IN SEMPLICE oro/argento	Lange	CV
SILVER DENIM ACC. LIGHT	Gif	CV
SILVER DENIM ACC. TELA	Gif	CV
SILVER DENIM IN SEMPLICE	Gif	CV
SILVER FELT LIGHT	Furpile	
SILVER FELT LIGHT IDRO	Furpile	CI 11/12
SILVER FELT REPS	Furpile	CI 11/12
SILVER FELT semplice	Furpile	CI 11/12
SILVER FELT TELA IDRO	Furpile	CI 11/12
SILVER FUSION LIGHT	Beccalli	CI 11/12
SILVER FUSION REPS	Beccalli	CI 11/12
SILVER FUSION SEMPLICE	Beccalli	CI 11/12
SILVER JAY ACC LIGHT	Beccalli	CCL
SILVER JAY ACC TELA	Beccalli	CCL
SILVER JAY ACC. REPS	Beccalli	
SILVER JAY IN SEMPLICE	Beccalli	CCL
SILVER LAND CRINKLE	Italdenim	CE 12
SILVER LAND CRINKLE LIGHT	Italdenim	CE 12
SILVER LAND LIGHT	Italdenim	CE 12
SILVER LAND SEMPLICE	Italdenim	CE 12
SILVER LAND TELA	Italdenim	CE 12
SILVER MESH	Piave	CE 11
SILVER MESH + STRETCH+DENIM FERRAGAMO	Piave	CSP
SILVER MOON LIGHT	Beccalli	CI 11/12
SILVER MOON REPS	Beccalli	CI 11/12
SILVER MOON SEMPLICE	Beccalli	CI 11/12
SILVER NIGHT REPS + IDRO	Frigerio	CSP
SILVER PYTON ACC LIGHT argento	Frigerio	CCL
SILVER PYTON ACC LIGHT colorato	Frigerio	CCL
SILVER PYTON ACC LIGHT oro satinato	Frigerio	CCL
SILVER PYTON ACC TELA argento	Frigerio	CCL
SILVER PYTON ACC TELA colorato	Frigerio	CCL
SILVER PYTON ACC TELA oro satinato	Frigerio	CCL
SILVER PYTON IN SEMPLICE argento	Frigerio	CCL
SILVER PYTON IN SEMPLICE colorato	Frigerio	CCL
SILVER PYTON IN SEMPLICE ORO SATINATO	Frigerio	CCL
SILVER SAND LIGHT	Forma	CE 12
SILVER SAND SEMPLICE	Forma	CE 12
SILVER SAND TELA	Forma	CE 12
SILVER SAND VECCHIO ACC LIGHT	Lange	CCL
SILVER SAND VECCHIO ACC TELA	Lange	CCL
SILVER SAND VECCHIO IN SEMPLICE	Lange	CCL
SILVER SKIN  ACC LIGHT	Corti	CI 10/11
SILVER SKIN  ACC REPS	Corti	CI 10/11
SILVER SKIN  IN SEMPLICE	Corti	CI 10/11
SILVER SKY  ACC REPS	Tat	CE 12
SILVER SKY  IN SEMPLICE		CV
SILVER SKY LIGHT	Tat	CE 12
SILVER SKY SEMPLICE	Tat	CE 12
SILVER SKY vecchio IN SEMPLICE	Dalmatex	CV
SILVER SKY vecchioACC. TELA	Dalmatex	CV
SILVER SKY vecchioACC.LIGHT	Dalmatex	CV
SILVER STONE light CRINKLE PE 12	Italdenim	CE 12
SILVER STONE LIGHT PE 12	Italdenim	CE 12
SILVER STONE SEMPLICE  PE 12	Italdenim	
SILVER STONE SEMPLICE CRINKLE PE 12	Italdenim	CE 12
SILVER STONE TELA PE 12	Italdenim	CE 12
SILVER WAVE	My Way	CCL
SILVER WEST ACC. LIGHT ORO/ARGENTO	My Way	CV
SILVER WEST ACC. REPS ORO/ARGENTO	My Way	CV
SILVER WEST COLORATO ACC. LIGHT	My Way	CV
SILVER WEST COLORATO ACC. REPS	My Way	CV
SILVER WEST COLORATO ACC. REPS + LIZARD	My Way	CV
SILVER WEST COLORATO IN SEMPLICE	My Way	CV
SILVER WEST IN SEMPLICE ORO/ARGENTO	My Way	CV
SILVER ZICKY	Dalmatex	CV
SILVERBAAL ACC. DENIM NERO	Corti	CSP
SILVERBAAL ACC. DENIM NERO + IDRO BEROFIN	Corti	CSP
SILVERBAAL ACC. REPS	Corti	
SILVERBAAL ACC. REPS + IDRO BEROFIN	Corti	CSP
SILVERBALL ACC. LIGHT	Corti	CCL
SILVERBALL ACC. TELA	Corti	CCL
SILVERBALL IN SEMPLICE	Corti	CCL
SILVERIZE	Tat	CV
SILVERIZE ACC. LIGHT	Taborelli	CV
SILVERIZE ACC. REPS	Taborelli	CV
SILVERIZE IN SEMPLICE	Taborelli	CV
SIMON LIGHT	My Way	CCL
SIMON REPS	My Way	CCL
SIMON SEMPLICE	My Way	CCL
SIMON SEMPLICE TINTO	My Way	
SIMON TELA	My Way	CCL
SIMPLY + AIRO MORBIDO + RESINATURA	Lange	CCL
SIMPLY ACC. LIGHT	Lange	CCL
SIMPLY ACC. TELA	Lange	CCL
SIMPLY IN SEMPLICE	Lange	CCL
SIMPLY WHITE	Radici Group	CI09/10
SINCLAIR LOFT	Taborelli	CI09/10
SINCLAIR TELA	Taborelli	CI09/10
SIXTY JAM ACC. DENIM	Corti	CV
SIXTY JAM ACC. LIGHT	Corti	CV
SIXTY JAM ACC. REPS	Corti	CV
SIXTY JAM IN SEMPLICE	Corti	CV
SIXTY MAGLINA TINTO CORTI	Corti	CV
SIXTY MAGLINA TINTO SDC	Corti	CV
SIXTY ONE ACC. TELA COLORATA	My Way	CCL
SIXTY ONE ACC. TELA ORO/ARGENTO	My Way	CCL
SIXTY ONE REPS COLORATI	My Way	CCL
SKATER ACC LIGHT	Tat	CE 10
SKATER ACC TELA	Tat	CE 10
SKATER IN SEMPLICE	Tat	CE 10
SKY	Corti	CV
SKY GLITTER greggio	Lange	CV
SKY GLITTER tinto	Lange	CV
SKY MESH	Lange	CV
SKY ROCK   PE 12	Eurojersey	CE 12
SKY STRETCH ACC LIGHT	Taborelli	CI09/10
SKY STRETCH ACC REPS	Taborelli	CI09/10
SKY STRETCH IN SEMPLICE	Taborelli	CI09/10
SKY WALKER ACC LIGHT	Corti	CI09/10
SKY WALKER ACC TELA	Corti	CI09/10
SKY WALKER ACC. DENIM	Corti	
SKY WALKER ACC. DENIM + IDRO BEROFIN	Corti	
SKY WALKER IN SEMPLICE	Corti	CI09/10
SLAM BALL ACC. LIGHT COLNERO	Corti	CCL
SLAM BALL ACC. LIGHT COLORATI	Corti	CCL
SLAM BALL ACC. REPS COL.NERO	Corti	CCL
SLAM BALL ACC. REPS COLORATI	Corti	CCL
SLAM BALL ACC. TELA COL.NERO	Corti	CCL
SLAM BALL ACC. TELA COLORATI	Corti	CCL
SLAM BALL IN SEMPLICE COL.NERO	Corti	CCL
SLAM BALL IN SEMPLICE COLORATII	Corti	CCL
SLAM BALL RESINATO COL.CHIARI	Corti	CCL
SLAM BALL RESINATO COL.NERO	Corti	CCL
SLAYER	Uco	CV
SLEEK REPS	Gif	CV
SLEEK SEMPLICE	Gif	CV
SLEEK SOFT	Gif	CV
SLEEK SPALMATO	Gif	CV
SLIGO  RESINATO	Lange	CV
SLIGO  SEMPLICE	Lange	CV
SLIGO LIGHT	Lange	CV
SLIGO SOFT	Lange	CV
SLIGO TELA	Lange	CV
SLOW BAY	Lange	CE 10
SMART CRINKLE ACC. LIGHT	Griffine	CV
SMART CRINKLE ACC. LIGHT MORO/NERO	Griffine	CV
SMART CRINKLE IN SEMPLICE	Griffine	CV
SMART CRINKLE IN SEMPLICE MORO/NERO	Griffine	CV
SMART LOFT	Griffine	CCL
SMART semplice	Griffine	CCL
SMART TELA	Griffine	CCL
SMASH RESINATO	Lange	CV
SMASH SEMPLICE	Lange	CV
SMASH SOFT	Lange	CV
SMASH TELA	Lange	CV
SMOKE  ACC. TELA	Sat idea	CCL
SMOKE + SMOKE	Sat idea	CSP
SMOKE ACC. LIGHT	Sat idea	CCL
SMOKE ACC. MTP 1,5 + LIGHT	Sat idea	CV
SMOKE DENIM	Sat idea	CCL
SMOKE IN SEMPLICE	Sat idea	CCL
SMOKE REPS	Sat idea	CCL
SMOKE RESINATO	Sat idea	CCL
SMOKE SCUBA	Sat idea	CCL
SMOKE SOFT	Sat idea	CCL
SMOKE STRETCH ACC. LOFT	Taborelli	CCL
SMOKE STRETCH ACC.TELA	Taborelli	CCL
SMOKE STRETCH IN SEMPLICE	Taborelli	CCL
SMOVE ACC. LIGHT	Beccalli	CV
SMOVE ACC. REPS	Beccalli	CCL
SMOVE IN SEMPLICE	Beccalli	CV
SNAKE FELT	Lanificio di soci	CI 11/12
SNAKY REPS	Star	CV
SNAKY RESINATO	Star	CV
SNAKY SEMPLICE	Star	CV
SNAKY SOFT	Star	CV
SNIPER SEMPLICE	Lange	CV
SNIPER SOFT	Lange	CV
SNIPER TELA	Lange	CV
SNOW TARTAN ART 68 CRINKLE	Taborelli	CI 10/11
SNOW TARTAN ART 68 IN SEMPLICE	Taborelli	CI 10/11
SOFIA	Taborelli	CV
SOFIA ACC. LIGHT	Frigerio	CV
SOFIA ACC. TELA	Frigerio	CV
SOFIA IN SEMPLICE	Frigerio	CV
SOFTY	Giardini	CV
SOKOS IN SEMPLICE	Salt 93	CV
SOKOS SOFT	Salt 93	CV
SOKOS TELA	Salt 93	CV
SONIC ACC LIGHT oro/argento	Corti	CCL
SONIC ACC TELA oro/argento	Corti	CCL
SONIC COLORATO ACC LIGHT	Corti	CCL
SONIC COLORATO ACC TELA	Corti	CCL
SONIC COLORATO IN SEMPLICE	Corti	CCL
SONIC IN SEMPLICE oro/argento	Corti	CCL
SONIC LOFT	Toia	CV
SONIC REPS	Toia	CV
SONIC SEMPLICE	Toia	CV
SONIC SPALMATO	Toia	CV
SONNY	Corti	CV
SOUL LADY ACC LIGHT	Taborelli	CE 10
SOUL LADY ACC REPS	Taborelli	CE 10
SOUL LADY IN SEMPLICE	Taborelli	CE 10
SOUL SEVEN	Sat idea	CV
SOUL ZONE	Tat	CV
SPACE	Taborelli	CV
SPACE RUNNER denim + idro	Corti	CSP
SPACE RUNNER LIGHT	Corti	CI 11/12
SPACE RUNNER REPS	Corti	CI 11/12
SPACE RUNNER SEMPLICE	Corti	CI 11/12
SPARK IN SEMPLICE	Tex Fation	CV
SPARK SOFT	Tex Fation	CV
SPARK SPALMATO	Tex Fation	CV
SPARK TELA	Tex Fation	CV
SPEED REPS	Mizar	CV
SPEED RESINATO	Mizar	CV
SPEED SCUBA	Mizar	CV
SPEED SEMPLICE	Mizar	CV
SPEED SOFT	Mizar	CV
SPENCER	Corti	CV
SPICE	Maglificio Tgv	CV
SPIDER ACC LIGHT	Corti	CI09/10
SPIDER ACC TELA	Corti	CI09/10
SPIDER ACC. DENIM	Corti	
SPIDER IN SEMPLICE	Corti	CI09/10
SPIGATO BURBERRY RESINATO	Lange	CV
SPIGATO BURBERRY SEMPLICE	Lange	CV
SPIGATO BURBERRY SOFT	Lange	CV
SPIGATO BURBERRY TELA	Lange	CV
SPIKER	Corti	CV
SPINN ACC. LIGHT	Corti	CV
SPINN ACC. REPS	Corti	CV
SPINN ACC. TELA	Corti	CV
SPINN IN SEMPLICE	Corti	CV
SPINNAKER ACC. LIGHT	Corti	CV
SPINNAKER ACC. REPS	Corti	CV
SPINNAKER ACC. SOFT	Corti	CV
SPINNAKER CRINKLE ACC. LIGHT	Corti	CV
SPINNAKER CRINKLE ACC. REPS	Corti	CV
SPINNAKER CRINKLE ACC. SOFT	Corti	CV
SPINNAKER CRINKLE IN SEMPLICE	Corti	CV
SPINNAKER IN SEMPLICE	Corti	CV
SPYMAKER ACC LIGHT	Frigerio	CI 10/11
SPYMAKER ACC REPS	Frigerio	CI 10/11
SPYMAKER IN SEMPLICE	Frigerio	CI 10/11
SQUASH LIGHT	Perlini	CV
SQUASH REPS	Perlini	CV
SQUASH RESINATO	Perlini	CV
SQUASH SEMPLICE	Perlini	CV
SQUASH SOFT	Perlini	CV
SQUASH TELA	Perlini	CV
ST- TROPEX ACC. ST. TROPEZ	Lange	CV
ST TROPEZ RESINATO BEROFIN	Lange	CSP
ST TROPEZ TELA +IDRO	Lange	CSP
ST. BARTH	Lange	CV
ST. MAXIN ACC. LIGHT	Lange	CV
ST. MAXIN ACC. TELA	Lange	CV
ST. TROPEZ LAV. PELL TIPO TRAVIS ACC. LIGHT	Lange	CV
ST.LOUIS SEMPLICE	Tat	CV
ST.MAXIN IN SEMPLICE	Lange	CV
ST.TROPEZ ACC. LIGHT	Lange	CCL
ST.TROPEZ ACC. TELA	Lange	CCL
ST.TROPEZ CRINKLE	Lange	CE 10
ST.TROPEZ CRINKLE ACC LIGHT	Lange	CE 10
ST.TROPEZ IN SEMPLICE	Lange	CCL
ST.TROPEZ LAV PELL TIPO TRAVIS ACC. TELA	Lange	CV
ST.TROPEZ RESINATO	Lange	CCL
STAMPA LEOPARDO SU KIKO REPS	Beccalli	CSP
STAMPA LEOPARDO SU KIKO SEMPLICE	Beccalli	CSP
STAR FLASH	Pozzi	CE 10
STAR LIGHT LIGHT	Taborelli	CV
STAR LIGHT REPS	Taborelli	CV
STAR LIGHT SEMPLICE	Taborelli	CV
STAR SCUBA	Sitip	CSP
STAR SCUBA B & B + 1,5 IGNIFUGO	Sitip	CSP
STAWBERRY ACC. REPS	Sitip	
STEALTH  BRIC'S  ACC. TELA IMPORT	Tat	CSP
STEALTH ACC. KYKO ABILINE	Tat	CSP
STEALTH ACC. LIGHT	Tat	CCL
STEALTH BEIGE TELA X MUNRO	Tat	CSP
STEALTH BRIC'S ACC. TELA ITALIA	Tat	CSP
STEALTH BRIC'S ACC. TELA NERA	Tat	CSP
STEALTH DENIM + IDRO BEROFIN	Tat	CCL
STEALTH DENIM+IDRO BEROFIN prezzo gg aumentato	Tat	CSP
STEALTH REPS+IDRO	Tat	CCL
STEALTH RESINATO	Tat	CCL
STEALTH RESINATO IDROR.	Itam	CCL
STEALTH RESINATO IGNIFUGO	Tat	CSP
STEALTH SEMPLICE	Tat	CCL
STEALTH SOFT	Tat	CCL
STEALTH TELA BRICS TAT	Tat	CSP
STEALTH TELA+IDRO	Tat	CCL
STEALTH var 20-21 DENIM + IDRO BEROFIN	Tat	
STEALTH var 20-21 LIGHT	Tat	CCL
STEALTH var 20-21 REPS + IDRO BEROFIN	Tat	CCL
STEALTH var 20-21 SEMPLICE	Tat	CCL
STEALTH var 20-21 TELA + IDRO BEROFIN	Tat	
STEALTH var 28-30 REPS + IDRO BEROFIN	Tat	CCL
STEALTH WHITE var 28-30 DENIM + IDRO BEROFIN	Tat	CCL
STEALTH WHITE var 28-30 LIGHT	Tat	CCL
STEALTH WHITE var 28-30 SEMPLICE	Tat	CCL
STEALTH WHITEvar 28-30 TELA+ IDRO BEROFIN	Tat	CCL
STEALTH WINCH LIGHT	Tat	CI 11/12
STEALTH WINCH SEMPLICE	Tat	CI 11/12
STEALTH WINCH TELA	Tat	CI 11/12
STEEL  IN SEMPLICE	Lange	CV
STEEL  RESINATO	Lange	CV
STEEL  TELA	Lange	CV
STEEL ACC. LIGHT	Lange	CV
STEEL ACC. LIGHT + IDRO BEROFIN	Lange	CV
STEEL ACC. LIGHT + IDRO EUROFINISS	Lange	CV
STEEL BRONZO ACC. SOFT	Lange	CV
STEEL CO 100% SOFT  IDRO	Lange	CV
STEEL REPS	Lange	CCL
STEEL SOFT	Lange	CCL
STERTCH NERO SEMPLICE	Carvico	CV
STIFF REPS	Tessile Operati	CV
STIFF SEMPLICE	Tessile Operati	CV
STIFF SOFT	Tessile Operati	CV
STIFF SPALMATO	Tessile Operati	CV
STONE ACC. TELA	Lange	CV
STONE ACC.LIGHT	Lange	CV
STONE BRISE'	Furpile	CI 11/12
STONE CROCO	Lange	CI 11/12
STONE CROCO  ACC DENIM	Lange	CSP
STONE FLASH (vecchia)ACC LIGHT	Lange	CCL
STONE FLASH (vecchia)ACC TELA	Lange	CCL
STONE FLASH (vecchia)IN SEMPLICE	Lange	CCL
STONE FLASH CRINKLE	Italdenim	CI 11/12
STONE FLASH CRINKLE LIGHT	Italdenim	CI 11/12
STONE FLASH LIGHT	Italdenim	CI 11/12
STONE FLASH REPS	Italdenim	
STONE FLASH SEMPLICE	Italdenim	CI 11/12
STONE FLASH TELA	Italdenim	CI 11/12
STONE FLOWER LIGHT PE 12	Ricamificio 2G	CE 12
STONE FLOWER SEMPLICE PE 12	Ricamificio 2G	CE 12
STONE FLOWER TELA PE 12	Ricamificio 2G	CE 12
STONE FLOWER VAR 1 SECRET B.CO LIGHT	Ricamificio 2G	CE 12
STONE FLOWER VAR 1 SECRET B.CO SEMPLICE	Ricamificio 2G	CE 12
STONE FLOWER VAR 1 SECRET B.CO TELA	Lange	CE 12
STONE FUSION light	Italdenim	CI 11/12
STONE FUSION SEMPLICE	Italdenim	CI 11/12
STONE FUSION TELA	Italdenim	CI 11/12
STONE IN SEMPLICE	Lange	CV
STONE LACE LIGHT PE 12	Arianna pizzi	CE 12
STONE LACE SEMPLICE PE 12	Arianna pizzi	CE 12
STONE LACE TELA PE 12	Arianna pizzi	CE 12
STONE LACE VAR 1 SECRET B.CO LIGHT	Arianna pizzi	CE 12
STONE LACE VAR 1 SECRET B.CO SEMPLICE	Arianna pizzi	CE 12
STONE LACE VAR 1 SECRET B.CO TELA	Arianna pizzi	CE 12
STONE LINUS ACC LIGHT	My Way	CE 11
STONE LINUS ACC REPS	My Way	
STONE LINUS CRINKLE	My Way	CE 11
STONE LINUS CRINKLE LIGHT	My Way	CE 11
STONE LINUS IN SEMPLICE	My Way	CE 11
STONE MYMETIC ACC LIGHT	Lange	CSP
STONE MYMETIC ACC TELA	Lange	CSP
STONE MYMETIC in semplice	Lange	CSP
STONE PLAID LIGHT	Italdenim	CI 11/12
STONE PLAID SEMPLICE	Italdenim	CI 11/12
STONE PLAID TELA	Italdenim	CI 11/12
STONE SAND CRINKLE  PE 12	Longo	CE 12
STONE SAND CRINKLE LIGHT PE 12	Longo	CE 12
STONE SAND LIGHT PE 12	Longo	CE 12
STONE SAND REPS PE 12	Longo	CE 12
STONE SAND SEMPLICE PE 12	Longo	CE 12
STONE SAND VAR 1 SECRET B.CO CRINKLE	Longo	CE 12
STONE SAND VAR 1 SECRET B.CO CRINKLE LIGHT	Longo	CE 12
STONE SAND VAR 1 SECRET B.CO LIGHT	Longo	CE 12
STONE SAND VAR 1 SECRET B.CO REPS	Longo	CE 12
STONE SAND VAR 1 SECRET B.CO SEMPLICE	Longo	CE 12
STONE SEX ACC. LIGHT	Uco	CV
STONE SEX ACC. TELA	Uco	CV
STONE SEX IN SEMPLICE	Uco	CV
STONE SKY  VAR 1 SECRET B.CO SEMPLICE	Ricamificio 2G	CE 12
STONE SKY LIGHT PE 12	Ricamificio 2G	CE 12
STONE SKY LIGHT VAR 1 SECRET B.CO	Ricamificio 2G	CE 12
STONE SKY SEMPLICE PE 12	Ricamificio 2G	
STONE SKY TELA PE 12	Ricamificio 2G	CE 12
STONE SKY VAR 1 SECRET B.CO TELA	Ricamificio 2G	CE 12
STONE SNAKE	Lange	
STONE TWILL LIGHT	Corti	CE 12
STONE TWILL REPS	Corti	CE 12
STONE TWILL SEMPLICE	Corti	CE 12
STONE VELVET IN SEMPLICE	Salt 93	CV
STONE VELVET SOFT	Salt 93	CV
STONE VELVET TELA	Salt 93	CV
STONE WAVE CRINKLE	Italdenim	CE 12
STONE WAVE SEMPLICE	Italdenim	CE 12
STONE WAVE TELA	Italdenim	CE 12
STONE WAVE TELA CRINKLE	Italdenim	CE 12
STONER ACC LIGHT	Sitip	CI09/10
STONER ACC REPS	Sitip	CI09/10
STONER IN SEMPLICE	Sitip	CI09/10
STORM	Sitip	CV
STRANGE	Gif	CV
STRAWBERRY ACC LIGHT	Sitip	CE 10
STRAWBERRY ACC REPS	Sitip	CE 10
STRAWBERRY ACC TELA	Sitip	
STRAWBERRY IN SEMPLICE	Sitip	CE 10
STREET METAL ACC. COME CRINKLE  FIVE	Corti	CV
STREET METAL ACC. LIGHT	Corti	CCL
STREET METAL ACC. SOFT	Corti	CCL
STREET METAL ACC. TELA	Corti	CCL
STREET METAL IN SEMPLICE	Corti	CCL
STREET METAL ORO ARGENTO SEMPLICE	Corti	CV
STREET METAL ORO ARGENTO SOFT	Corti	CV
STREET METAL ORO ARGENTO TELA	Corti	CV
STREET METAL SCUBA COLORATI	Corti	CV
STREET METAL SCUBA ORO ARGENTO	Corti	CV
STRETCH ACC. BREMBO CROSERIO	Carvico	CV
STRETCH BIANCO ACC. DENIM	Carvico	CCL
STRETCH BIANCO ACC. REPS	Carvico	CCL
STRETCH BIANCO ACC. STRETCH	Carvico	CCL
STRETCH BIANCO SEMPLICE	Carvico	CCL
STRETCH COLORATI ACC. DENIM	Carvico	CCL
STRETCH COLORATI ACC. REPS	Carvico	CCL
STRETCH COLORATI ACC. STRETCH	Carvico	CCL
STRETCH COLORATI SEMPLICE	Carvico	CCL
STRETCH FLAG	Carvico	CV
STRETCH NERO ACC. DENIM	Carvico	CCL
STRETCH NERO ACC. STRETCH	Carvico	CCL
STRETCH NERO ACC.REPS	Carvico	CCL
STRETCH NERO IN SEMPLICE	Carvico	CCL
STRETCH SCUBA BIANCO	Carvico	CCL
STRETCH SCUBA COLORATI	Carvico	CCL
STRETCH SCUBA NERO	Carvico	CCL
STRETCH SCUBA RIEKER	Carvico	CV
STRIPE	Ambiente Uomo	CV
STRIPE BASKET	Lange	CV
STRIPE BAY ACC. LIGHT	Beccalli	CV
STRIPE BAY ACC. REPS	Beccalli	CV
STRIPE BAY IN SEMPLICE	Beccalli	CV
STRIPE BERRY  SEMPLICE	Lange	CV
STRIPE BERRY LIGHT	Lange	CV
STRIPE BERRY RESINATO	Lange	CV
STRIPE BERRY SOFT	Lange	CV
STRIPE BERRY TELA	Lange	CV
STRIPE DENIM LIGHT	Berto spa	CV
STRIPE DENIM SEMPLICE	Berto spa	CV
STRIPE DENIM TELA	Berto spa	CV
STRIPE RESINATO	Toia	CV
STRIPE SEMPLICE	Toia	CV
STRIPE SOFT	Toia	CV
STRIPE SOFT ACC. LIGHT	Beccalli	CV
STRIPE SOFT ACC. REPS	Beccalli	CV
STRIPE SOFT IN SEMPLICE	Beccalli	CV
STRIPE TELA	Toia	CV
SUGAR STRETCH	Raion Inveruno	CV
SUKKO REPS	Ambiente Uomo	CV
SUKKO RESINATO	Ambiente Uomo	CV
SUKKO SEMPLICE	Ambiente Uomo	CV
SUKKO SOFT	Ambiente Uomo	CV
SUKKO SOFT V.1	Ambiente Uomo	CV
SUMATRA LIGHT	Frigerio	CV
SUMATRA SEMPLICE	Frigerio	CV
SUMATRA TELA	Frigerio	CV
SUMMER CHECK ACC. LIGHT	Taborelli	
SUMMER CHECK ACC. REPS	Taborelli	
SUMMER CHECK IN SEMPLICE	Taborelli	
SUMMER STRIPE ACC. LIGHT	Mectex	CCL
SUMMER STRIPE ACC. TELA	Mectex	CCL
SUMMER STRIPE IN SEMPLICE	Mectex	CCL
SUN CITY	Itam Mi	CV
SUN KISS	Radici Group	CI09/10
SUNSET	Toia	CV
SUNSET ACC. LIGHT VAR. 2/3/4/5/6	Forma	CCL
SUNSET ACC. LIGHT VAR.1/7/8/9/10	Forma	CCL
SUNSET ACC. TELA VAR. 2/3/4/5/6	Forma	CCL
SUNSET ACC. TELA VAR.1/7/8/9/10	Forma	CCL
SUNSET IN SEMPLICE VAR.1/7/8/9/10	Forma	CCL
SUNSET LIGHT	Forma	CCL
SUNSET RESINATO VAR. 1/7/8/9/10	Forma	CCL
SUNSET RESINATO VAR. 2/3/4/5/6	Forma	CCL
SUNSET SEMPLICE	Forma	CCL
SUNSET SEMPLICE VAR.2/3/4/5/6	Forma	CCL
SUNSET TELA	Forma	CCL
SUPERNATURAL	Lange	CV
SUPPORTO PANAMA CITY X GEOX	Clementi	CV
SURF	Carvico	CV
SWAMI ACC LIGHT	Taborelli	CI09/10
SWAMI ACC TELA	Taborelli	CI09/10
SWAMI IN SEMPLICE	Taborelli	CI09/10
SWAMI VELVET ACC REPS	Namsan Technology	CI09/10
SWING	Lange	CV
SYLVER PYTON IN SEMPLICE oro satinato	Frigerio	CV
SYNCRO MESH REPS	Piave	
SYNCRO MESH SEMPLICE	Piave	CI 11/12
SYNCRO MESH TELA	Piave	CI 11/12
TAHISH	Taborelli	CV
TAKI REPS	Mariani cinese	CV
TAKI RESINATO	Mariani cinese	CV
TAKI SEMPLICE	Mariani cinese	CV
TAKI SOFT	Mariani cinese	CV
TAMUI	Fipel	CV
TANK LOFT	Corti	CV
TANK SUEDE LIGHT	Ciemme	CI 11/12
TANK SUEDE REPS	Ciemme	CI 11/12
TANK SUEDE SEMPLICE	Ciemme	CI 11/12
TARTAN ACC. DENIM	Magitex	CCL
TARTAN ACC. LIGHT	Magitex	CCL
TARTAN ACC. REPS	Magitex	CCL
TARTAN ACC. REPS BEROFIN	Magitex	CCL
TARTAN ACC. SOFT	Magitex	CCL
TARTAN GLASS	Magitex	
TARTAN IN SEMPLICE	Magitex	CCL
TARTAN MTP 2MM	Magitex	CCL
TARTAN RESINATO DIR.FILO + IDRO BEROFIN	Magitex	CCL
TARTAN TRAPUNTATO DIAMANTE	Magitex	CSP
TATTOO ACC  LIGHT	Lange	CE 10
TATTOO ACC TELA	Lange	CE 10
TATTOO IN SEMPLICE	Lange	CE 10
TATUAGE	Griffine	CCL
TAYO DENIM	Eurojersey	CV
TAYO STRETCH	Eurojersey	CV
TECH MESH ART 63 ACC LIGHT	Corti	CI 10/11
TECH MESH ART 63 ACC TELA	Corti	CI 10/11
TECH MESH ART 63 IN SEMPLICE	Corti	CI 10/11
TECH RUNNER IN SENPLICE	Radici Group	CE 10
TECH RUNNER LIGHT	Radici Group	CE 10
TECNICO 7G DENIM + IDRO	Lazzati	CSP
TEJI SEMPLICE	Griffine	CV
TEJI STRETCH	Griffine	CV
TEJI TELA	Griffine	CV
TEK METAL ACC TELA	Sitip	CCL
TEK METAL ACC. LIGHT	Sitip	CCL
TEK METAL ACC. REPS	Sitip	CCL
TEK METAL ACC. REPS+IDRO BIANCO TOD'S	Sitip	
TEK METAL IN SEMPLICE	Sitip	CCL
TEKNO BABY acc light	Taborelli	CV
TEKNO BABY acc tela	Taborelli	CV
TEKNO BABY IN SEMPLCE	Taborelli	CCL
TEKNO BASKET ACC. TELA	Romano'	CCL
TEKNO BASKET ACC.LIGHT	Romano'	CCL
TEKNO BASKET IN SEMPLICE	Romano'	CCL
TEKNO BLACK  LIGHT	Lazzati	CI 11/12
TEKNO BLACK  REPS	Lazzati	CI 11/12
TEKNO BLACK SEMPLICE	Lazzati	CI 11/12
TEKNO BLUE DENIM	Raion Inveruno	CSP
TEKNO BLUE DENIM + IDRO	Raion Inveruno	CSP
TEKNO BLUE LIGHT	Raion Inveruno	CE 12
TEKNO BLUE REPS	Raion Inveruno	CSP
TEKNO BLUE SEMPLICE	Raion Inveruno	CE 12
TEKNO BLUE TELA	Raion Inveruno	CE 12
TEKNO CHEVRON  LIGHT	Lazzati	CI 11/12
TEKNO CHEVRON  LIGHT+idro	Lazzati	CSP
TEKNO CHEVRON  REPS	Lazzati	CI 11/12
TEKNO CHEVRON SEMPLICE	Lazzati	CI 11/12
TEKNO CHIC LIGHT PE 12	Frigerio	
TEKNO CHIC REPS PE 12	Frigerio	CE 12
TEKNO CHIC SEMPLICE PE 12	Frigerio	CE 12
TEKNO CINZ ACC. REPS	Corti	CCL
TEKNO CINZ ACC. TELA	Corti	CCL
TEKNO CINZ IN SEMPLICE	Corti	CCL
TEKNO FLUID LIGHT	Corti	CI 11/12
TEKNO FLUID PRONTO STAMPA SEMPLICE	Corti	CCL
TEKNO FLUID REPS	Corti	CI 11/12
TEKNO FLUID SEMPLICE	Corti	CI 11/12
TEKNO ICE ACC LIGHT	Frigerio	CE 12
TEKNO ICE ACC REPS	Frigerio	CE 12
TEKNO ICE SEMPLICE	Frigerio	CE 12
TEKNO MYMETIC ACC LIGHT BEROFIN	Lamintess	CI 10/11
TEKNO MYMETIC ACC REPS	Lamintess	CI 10/11
TEKNO MYMETIC IN SEMPLICE	Lamintess	CI 10/11
TEKNO PANAMA ACC LIGHT	Lazzati	CE 11
TEKNO PANAMA ACC REPS	Lazzati	CE 11
TEKNO PANAMA IN SEMPLICE	Lazzati	CE 11
TEKNO PANAMA TINTO X TOD' S LIGHT	Lazzati	CSP
TEKNO PANAMA TINTO X TOD' S REPS	Lazzati	CSP
TEKNO PANAMA TINTO X TOD' S SEMPLICE	Lazzati	CSP
TEKNO POP	Corti	CV
TEKNO SATIN ACC LIGHT+idro	Corti	CCL
TEKNO SATIN ACC OVATTA 60	Corti	CSP
TEKNO SATIN ACC TELA	Corti	CCL
TEKNO SATIN DENIM+idro	Corti	CI 10/11
TEKNO SATIN IN SEMPLICE	Corti	CCL
TEKNO SATIN PRONTO STAMPA SEMPLICE	Corti	CCL
TEKNO SATIN REPS+idro	Corti	CCL
TEKNO SCUBA	Tat	CCL
TEKNO STRETCH ACC. LYCRA  COLORATA	Tat	CV
TEKNO STRETCH ACC. REPS	Tat	
TEKNO STRETCH LOFT	Tat	CCL
TEKNO STRETCH LYCRA NERA	Tat	CCL
TEKNO STRETCH METAL LUCIDO ACC. LOFT	Tat	CCL
TEKNO STRETCH METAL LUCIDO ACC. TELA	Tat	CCL
TEKNO STRETCH METAL LUCIDO IN SEMPLICE	Tat	CCL
TEKNO STRETCH SEMPLICE	Tat	CCL
TEKNO STRETCH STRETCH SPECCHIO	Tat	CCL
TEKNO WHITE LIGHT	Corti	CI 11/12
TEKNO WHITE REPS	Corti	CI 11/12
TEKNO WHITE SEMPLICE	Corti	CI 11/12
TEKNOSAIL ACC LIGHT	Lazzati	CE 11
TEKNOSAIL ACC REPS	Lazzati	CE 11
TEKNOSAIL IN SEMPLICE	Lazzati	CE 11
TEKNOSTONE ACC LIGHT	Corti	CE 11
TEKNOSTONE ACC REPS	Corti	CE 11
TEKNOSTONE CRINKLE	Corti	CE 11
TEKNOSTONE CRINKLE LIGHT	Corti	CE 11
TEKNOSTONE IN SEMPLICE	Corti	CE 11
TEL		CV
TELA AUDREY ACC. DENIM	Frigerio	CCL
TELA AUDREY ACC. DENIM BEROFIN	Frigerio	CCL
TELA AUDREY ACC. LIGHT	Frigerio	CCL
TELA AUDREY ACC. REPS BEROFIN	Frigerio	CCL
TELA AUDREY ACC. TELA  NERA	Frigerio	CCL
TELA AUDREY ACC. TELA BEROFIN	Frigerio	CCL
TELA AUDREY ACC. TELA FORATA	Frigerio	CV
TELA AUDREY ACC.LIGHT+IDRO EUROFINISS	Frigerio	CCL
TELA AUDREY IN SEMPLICE	Frigerio	CCL
TELA AUDREY RESINATA	Frigerio	CCL
TELA BASKET ACC. DENIM	Lange	CCL
TELA BASKET ACC. LIGHT	Lange	
TELA BASKET IN SEMPLICE	Lange	
TELA BASKET TELA	Lange	CCL
TELA BUDDA RESINATA	Lange	CCL
TELA BUDDHA ACC. LIGHT	Lange	CCL
TELA BUDDHA ACC. TELA	Lange	CCL
TELA BUDDHA IN SEMPLICE	Lange	CCL
TELA EUROPA +TINTURA+DELAVAGGIO SEMPL	Lange	
TELA FIJI ACC. LIGHT COLORATA	Lange	CCL
TELA FIJI ACC. LIGHT ORO/ARGENTO	Lange	CCL
TELA FIJI ACC. TELA COLORATA	Lange	CCL
TELA FIJI ACC. TELA ORO/ARGENTO	Lange	CCL
TELA FIJI IN SEMPLICE  ORO/ARGENTO	Lange	CCL
TELA FIJI IN SEMPLICE COLORATA	Lange	CCL
TELA SAND ACC. LIGHT	Lange	CCL
TELA SAND ACC. TELA	Lange	CCL
TELA SAND in semplice BIANCO STAMPA	Lange	CCL
TELA SAND IN SEMPLICE tinta	Lange	CCL
TEMPER	Yong Tong	CV
TEMPEST LIGHT	Corti	CV
TEMPEST RESINATO	Corti	CV
TEMPEST SEMPLICE	Corti	CV
TEMPEST TELA	Corti	CV
TENDER ACC. LIGHT	Maglificio Tgv	CV
TENDER ACC. REPS	Maglificio Tgv	CV
TENDER ACC. TELA	Maglificio Tgv	CV
TENDER IN SEMPLICE	Maglificio Tgv	CV
TEOS	Frigerio	CV
TERREL RESINATO	Lange	CV
TERREL SEMPLICE	Lange	CV
TERREL SOFT	Lange	CV
TERREL TELA	Lange	CV
TERREL TIPO HANCOCK SOFT	Lange	CV
TEX PLISSE'	Mariani cinese	CV
TEXAGO ACC.LIGHT	Dalmatex	CV
TEXAGO IN SEMPLICE	Dalmatex	CV
THAO	Forma	CV
THUNDER + SPALM. OPILUX DOUBLE FACE	Corti	
THUNDER ACC. LIGHT	Corti	CCL
THUNDER ACC. TELA	Corti	CCL
THUNDER IN SEMPLICE	Corti	CCL
TIFFANY	Mariani cinese	CV
TIGER CRINKLE LIGHT	Corti	CI 11/12
TIGER CRINKLE SEMPLICE	Corti	CI 11/12
TIGER LIGHT	Corti	CI 11/12
TIGER REPS	Corti	CI 11/12
TIGER SEMPLICE	Corti	CI 11/12
TIKO	Lange	CV
TIMOTHY LIGHT	Corti	CV
TIMOTHY REPS	Corti	CV
TIMOTHY RESINATO	Corti	CV
TIMOTHY SEMPLICE	Corti	CV
TIMOTHY SOFT	Corti	CV
TIMU	Corti	CV
TINKY	Perlini	CV
TOBY ACC. LIGHT	Uco	CV
TOBY ACC. TELA	Uco	CV
TOBY IN SEMPLICE	Uco	CV
TOGETHER RESINATO	Lange	CV
TOGETHER SEMPLICE	Lange	CV
TOGETHER SOFT	Lange	CV
TOGETHER TELA	Lange	CV
TOMMY COLORATI	Corti	CV
TOMMY ORO ARGENTO	Corti	CV
TOMOKO ACC. TELA	Taborelli	CV
TOMOKO LIGHT	Taborelli	CV
TOMOKO SEMPLICE	Taborelli	CV
TOP GUN  ACC. REPS EXPERT	Corti	CCL
TOP GUN  ACC. REPS EXPERT COL.1	Corti	CCL
TOP GUN  RESINATO COL.1	Corti	CCL
TOP GUN  SCUBA	Corti	CCL
TOP GUN ACC. LIGHT	Corti	CCL
TOP GUN ACC. LIGHT BEROFIN	Corti	CCL
TOP GUN ACC. LIGHT COL.1	Corti	CCL
TOP GUN ACC. LIGHT COL.1 BEROFIN	Corti	CCL
TOP GUN ACC. REPS BEROFIN	Corti	CCL
TOP GUN ACC. REPS BEROFIN COL.1	Corti	CCL
TOP GUN COL.1 IN SEMPLICE	Corti	CCL
TOP GUN IN SEMPLICE	Corti	CCL
TOP GUN RESINATO	Corti	CCL
TOP SAIL	Heat Coat	CCL
TOP SPIN ACC LIGHT + IDRO	Tat	CI09/10
TOP SPIN ACC TELA	Tat	CI09/10
TOP SPIN ACC. DENIM + IDRO BEROFIN	Tat	
TOP SPIN ACC. TELA + IDRO BEROFIN	Tat	
TOP SPIN DENIM	Tat	CI09/10
TOP SPIN IN SEMPLICE	Tat	CI09/10
TOP SPIN LIGHT	Tat	CI09/10
TOP SPIN TELA	Tat	CI09/10
TOSH ACC TELA	Lange	CCL
TOSH ACC. TELA +ORO SATINATO EUROFINISS	Lange	CSP
TOSHI	Piave	CV
TOTAL	Beccalli	CV
TOUCH	Croma srl	CV
TRACY ACC. REPS	Corti	CV
TRACY IN SEMPLICE	Corti	CV
TRACY RESINATO	Corti	CV
TRACY SOFT	Corti	CV
TRACY TELA	Corti	CV
TRANSIT REPS	Gif	CV
TRANSIT SEMPLICE	Gif	CV
TRANSIT SOFT	Gif	CV
TRANSIT SPALMATO	Gif	CV
TRAVIS REPS	Forma	CV
TRAVIS RESINATO	Forma	CV
TRAVIS SEMPLICE	Forma	CV
TRAVIS SOFT	Forma	CV
TRAVIS TELA	Forma	CV
TRUCK ACC. LIGHT	Lange	CV
TRUCK ACC. TELA	Lange	CV
TRUCK IN SEMPLICE	Lange	CV
TRUE JAZZ ACC. LIGHT	Namsan Technology	CV
TRUE JAZZ TELA	Namsan Technology	CV
TUKER	Perlini	CV
TURNER	Gif	CV
TUXEDO ACC. REPS COLORATO	Corti	CCL
TUXEDO IN SEMPLICE COLORATO	Corti	CCL
TUXEDO IN SEMPLICE oro/arg	Corti	CCL
TUXEDO LIGHT COLORATO	Corti	CCL
TWENTY SEVEN ACC. REPS	My Way	CV
TWENTY SEVEN IN SEMPLICE	My Way	CV
TWIGGY ACC LIGHT	Taborelli	CE 10
TWIGGY ACC TELA	Taborelli	CE 10
TWIGGY IN SEMPLICE	Taborelli	CE 10
TWILIGHT ACC LIGHT	Pozzi	CE 10
TWILIGHT ACC TELA	Pozzi	CE 10
TWILIGHT IN SEMPLICE	Pozzi	CE 10
TWILL 1 BURBERRY RESINATO	Lange	CV
TWILL 1 BURBERRY SEMPLICE	Lange	CV
TWILL 1 BURBERRY SOFT	Lange	CV
TWILL 1 BURBERRY TELA	Lange	CV
TWILL 1 BURBERRY TINTO	Lange	CV
TWILL 1 COTONE 100%	Lange	CV
TWILL 2 BURBERRY RESINATO	Lange	CV
TWILL 2 BURBERRY SEMPLICE	Lange	CV
TWILL 2 BURBERRY SOFT	Lange	CV
TWILL 2 BURBERRY TELA	Lange	CV
TWILL ADPEL ACC. LIGHT	Taborelli	CV
TWILL ADPEL ACC. MTP 1,5	Taborelli	CV
TWILL ADPEL ACC. TELA	Taborelli	CV
TWILL ADPEL IN SEMPLICE	Taborelli	CV
TWILL FERRAGAMO SEMPLICE	Corti	CSP
twill strong BAYONNE X BALLY LIGHT	Corti	CSP
TWILL STRONG BAYONNE x bally SEMPLICE	Corti	CSP
TWILL STRONG BAYONNE X BALLY TELA	Corti	CSP
TWIN FELT	My Way	CV
TWIST	Lange	CV
TWIST FIVE DENIM	Corti	CV
TWIST FIVE LIGHT	Corti	CV
TWIST FIVE SEMPLICE	Corti	CV
TWIST SEVEN COL CHIARI DENIM	Corti	CV
TWIST SEVEN COL CHIARI LIGHT	Corti	CV
TWIST SEVEN COL CHIARI SEMPLICE	Corti	CV
TWIST SEVEN COL SCURI DENIM	Corti	CV
TWIST SEVEN COL SCURI LIGHT	Corti	CV
TWIST SEVEN COL SCURI SEMPLICE	Corti	CV
TWIST SIX ACC. DENIM	Corti	CCL
TWIST SIX ACC. TELA + IDRO	Corti	CCL
TWIST SIX IN SEMPLICE	Corti	CCL
TWIST SIX LIGHT	Corti	CCL
TWIST SIX TELA	Corti	CCL
TWISTER DENIM	Sat idea	CV
TWISTER LIGHT	Sat idea	CV
TWISTER SEMPLICE	Sat idea	CV
TYLER ACTIVE LIGHT	Corti	CV
TYLER ACTIVE RESINATO	Corti	CV
TYLER ACTIVE SEMPLICE	Corti	CV
TYLER ACTIVE TELA	Corti	CV
TYLER DAVISON LIGHT V.1	Corti	CV
TYLER DAVISON LIGHT V.6	Corti	CV
TYLER DAVISON REPS V.1	Corti	CV
TYLER DAVISON REPS V.6	Corti	CV
TYLER DAVISON RESINATO V.1	Corti	CV
TYLER DAVISON RESINATO V.6	Corti	CV
TYLER DAVISON SEMPLICE V.1	Corti	CV
TYLER DAVISON SEMPLICE V.6	Corti	CV
TYLER KYKO LIGHT V.4	Beccalli	CV
TYLER KYKO LIGHT V.5	Beccalli	CV
TYLER KYKO REPS V.4	Beccalli	CV
TYLER KYKO REPS V.5	Beccalli	CV
TYLER KYKO RESINATO V.4	Beccalli	CV
TYLER KYKO RESINATO V.5	Beccalli	CV
TYLER KYKO SEMPLICE V.4	Beccalli	CV
TYLER KYKO SEMPLICE V.5	Beccalli	CV
TYLER KYKO TELA V. 5	Beccalli	CV
TYLER KYKO TELA V.4	Beccalli	CV
TYLER PLAYGROUND LIGHT	Corti	CV
TYLER PLAYGROUND RESINATO	Corti	CV
TYLER PLAYGROUND SEMPLICE	Corti	CV
TYLER PLAYGROUND TELA	Corti	CV
TYRON ACC LIGHT COLORATE	Corti	CCL
TYRON ACC LIGHT ORO/ARG	Radici Group	CCL
TYRON ACC REPS COLORATE	Corti	CCL
TYRON ACC REPS ORO/ARG	Radici Group	CCL
TYRON IN SEMPLICE COLORATE	Corti	CCL
TYRON IN SEMPLICE ORO/ARG	Radici Group	CCL
UNGARO COTONE LAME' DENIM	Texal	CV
UNGARO COTONE LAME' REPS	Texal	CV
UNGARO COTONE LAME' SEMPLICE	Texal	CV
UNGARO COTONE LAME' SOFT	Texal	CV
UNGARO COTONE LAME' TELA	Texal	CV
UNGARO VELLUTO OPERATO REPS	Molteni	CV
UNGARO VELLUTO OPERATO SEMPLICE	Molteni	CV
UNGARO VELLUTO OPERATO SOFT	Molteni	CV
UNGARO VELLUTO OPERATO TELA	Molteni	CV
VANDROSS ACC. LIGHT	Taborelli	CV
VANDROSS ACC. TELA	Taborelli	CV
VANDROSS IN SEMPLICE	Taborelli	CV
VELKO ACC. LIGHT	Redaelli	
VELKO REPS	Redaelli	CCL
VELKO SEMPLICE	Redaelli	CCL
VELKO SOFT	Redaelli	CCL
VELLUTO SETA ACC. LIGHT	My Way	CV
VELLUTO SETA ACC. REPS	My Way	CV
VELLUTO SETA ACC. TELA	My Way	
VELLUTO SETA IN SEMPLICE	My Way	CV
VELOUR GARDEN	Ciemme	CI 10/11
VELOUR STRETCH TINTO ACC LIGHT	Ciemme	CI 10/11
VELOUR STRETCH TINTO ACC LYCRA	Ciemme	CI 10/11
VELOUR STRETCH TINTO IN SEMPL	Ciemme	CI 10/11
VELOUR STRETCH TINTO REPS	Ciemme	CI 10/11
VELVET FIVE ACC. REPS	My Way	CCL
VELVET FIVE IN SEMPLICE	My Way	CCL
VELVET IN SEMPLICE vecchio	Tex Fation	CV
VELVET LARRY COLORATI ACC. REPS	My Way	CV
VELVET LARRY ORO/ARG	My Way	CV
VELVET LIGHT	Carvico	CV
VELVET REPS	Carvico	CV
VELVET SEMPLICE	Carvico	CV
VELVET SIX ACC. REPS	My Way	CV
VELVET SOFT vecchio	Salt 93	CV
VELVET ST.CHANEL SEMPLICE	Salt 93	CV
VELVET ST.CHANEL SOFT	Salt 93	CV
VELVET ST.CHANEL TELA	Salt 93	CV
VELVET TELA	Salt 93	CV
VELVET ZONE	My Way	CV
VENIX ACC TELA COLORATI	My Way	CV
VENIX ACC. LIGHT COLORATI	My Way	CV
VENIX CHAMBERS (RETE BIANCA)	Heat Coat	CSP
VENIX CHAMBERS (RETE COLORATA)	Heat Coat	CSP
VENIX POIS TELA	Beccalli	CV
VENIX SCUBA ACC STRETCH LOGAN	Dalmatex	CSP
VENIX SCUBA MTP 1,50	Dalmatex	CCL
VENIX SEMPLICE COLORATI	My Way	CV
VENIX STRETCH ACC. LIGHT	Dalmatex	CCL
VENIX STRETCH IN SEMPLICE	Dalmatex	CCL
VENIX VICHY ACC LIGHT	Beccalli	CV
VENIX VICHY ACC REPS	Beccalli	CV
VERNICE METAL	Dalmatex	CSP
VERNY FELT	My Way	CV
VERVE	Lange	CV
VESUVIAN REPS	Redaelli	CV
VESUVIAN SEMPLICE	Redaelli	CV
VESUVIAN SOFT	Redaelli	CV
VESUVIAN SPALMATO	Redaelli	CV
VIC	Lange	CV
VICHY ACC LIGHT	Taborelli	CV
VICHY ACC TELA	Taborelli	CV
VICHY IN SEMPLICE	Taborelli	
VIKING IN SEMPLICE	Sat idea	CV
VILLAGE  ACC. TELA	Ningbo Richtex	CV
VILLAGE ACC. LIGHT	Ningbo Richtex	CV
VILLAGE IN SEMPLICE	Ningbo Richtex	CV
VINIL RESINATO	Griffine	CV
VINIL SEMPLICE	Griffine	CV
VINIL SOFT	Griffine	CV
VINIL TELA	Griffine	CV
VINIX	Real	CV
VINNY	Corti	CV
VINNY CON BETA	Corti	CV
VIOLET	Namsan Technology	CV
VISONE UNITO	Furpile	CI 11/12
VULCA  SEMPLICE	Beccalli	CV
VULCAN LIGHT	Beccalli	CV
VULCAN REPS	Beccalli	CV
VULCANUS	Lange	CE 10
WADE IN SEMPLICE	Heat Coat	CV
WAILER	Forma	CV
WAINE REPS	Gif	CV
WAINE SEMPLICE	Gif	CV
WAINE SOFT	Gif	CV
WAINE SPALMATO	Gif	CV
WAKE	Carvico	CV
WALKER BIANCO	Miti	CV
WALKER COLORATO	Miti	CV
WALKER NERO	Miti	CV
WALLABY	Corti	CV
WALLACE BASE KYKO	Uboldi	CSP
WALLACE IN SEMPLICE	My Way	CCL
WALLACE TELA	My Way	CCL
WALLY  NERO/BIANCO	Piave	CCL
WALLY BIANCO	Piave	CCL
WALLY BIANCO + ICE METAL ACC. TELA	My Way	CV
WALLY CANVAS	Piave	
WALLY COLORATO	Piave	CCL
WALLY COLORATO + ICE METAL ACC. LIGHT	My Way	CV
WALLY COLORATO + ICE MTAL ACC. TELA	My Way	CV
WALLY DENIM	Piave	CSP
WALLY FIVE	Piave	CE 12
WALLY FLAG	Piave	CV
WALLY JUSTIN METAL ACC TELA	Piave	CSP
WALLY METAL COLORATI	Piave	CV
WALLY NERO + ICE METAL ACC. LIGHT	My Way	CV
WALLY NERO + ICE METAL ACC. TELA	My Way	CV
WALLY TAFFETA'	Piave	CE 12
WALLY TINTO+LYCRA+MTP+LYCRA	Piave	CSP
WALLY VENIX	Piave	CCL
WALLY VENIX TELA - WALLY COLORATO	Piave	
WALLY VENIX TELA - WALLY NERO	Piave	
WALLY ZICKY METAL	Dalmatex	CV
WALLYCOTTON	Piave	CV
WALLYGATOR +MTP 1,5 + LOFT	Piave	
WALLYGATOR BIANCO	Piave	CCL
WALLYGATOR COLORATO	Piave	CCL
WALLYGATOR COLORATO TELA	Piave	CCL
WALLYGATOR NERO	Piave	CCL
WALLYGATOR NERO TELA	Piave	CCL
WALLYGLITT DENIM BIANCO	Piave	CCL
WALLYGLITT DENIM NERO	Piave	CCL
WALLYGLITT LYCRA NERA	Piave	CCL
WALLYGLITT STRETCH BIANCO	Piave	CCL
WALLYKYKO	Beccalli	CV
WALLYKYKO  NON LAMINATO	Beccalli	CV
WALLYMAX COLORATI	Fillattice	CV
WALLYMAX NERO/BIANCO	Fillattice	CV
WALLYMESH	Valli	CV
WALLYMESH  TINTO DA VALLI	Valli	CV
WALLYMESH METAL	Valli	CV
WALLYMESH METAL TINTO VALLI	Valli	CV
WALLYMESH RETE BIANCA NERA	Valli	CV
WALLYWAVE	Piave	CV
WARHOL ACC. LIGHT	Taborelli	CV
WARHOL ACC. REPS	Taborelli	CV
WARHOL IN SEMPLICE	Taborelli	CV
WARREN	Lange	CV
WARRICK IN SEMPLICE BIANCO	Heat Coat	CV
WARRICK IN SEMPLICE COL.SCURI	Heat Coat	CV
WASAKI	Lange	CV
WATER ACC. LIGHT	Frigerio	CV
WATER ACC.TELA	Frigerio	CV
WATER IN SEMPLICE	Frigerio	CV
WAYANG VAR.1/3	Forma	CV
WAYANG VAR.2	Forma	CV
WAYLAND ACC. LIGHT	Ambiente Uomo	CV
WAYLAND ACC. REPS	Ambiente Uomo	CV
WAYLAND IN SEMPLICE	Ambiente Uomo	CV
WEBBER RESINATO	Lange	CV
WEBBER RESINATO COL.DA 500 MT	Lange	CV
WEBBER SEMPLICE	Lange	CV
WEBBER SOFT	Lange	CV
WEBBER TELA	Lange	CV
WEEKO	Piave	CV
WENDEL	Corti	CV
WESLEY	Real	CV
WEST ACC. LIGHT	Ambiente Uomo	CV
WEST ACC. REPS	Ambiente Uomo	CV
WEST BAY	Perlini	CV
WEST BAY LIGHT	Perlini	CV
WEST BAY REPS	Perlini	CV
WEST IN SEMPLICE	Ambiente Uomo	CV
WEST JERSEY D.15843 MONO V.	Luce	CV
WEST SAND ACC. LIGHT	Lange	CV
WEST SAND ACC. TELA	Lange	CV
WEST SAND IN SEMPLICE	Lange	CV
WEST SAND RESINATO	Lange	CV
WHITE  BEACH ACC. REPS	Taborelli	CV
WHITE BAY ACC. LIGHT	Lange	CV
WHITE BAY ACC. TELA	Lange	CV
WHITE BAY IN SEMPLICE	Lange	CV
WHITE BEACH ACC. LIGHT	Taborelli	CV
WHITE BEACH ACC. TELA	Taborelli	CV
WHITE BEACH IN SEMPLICE	Taborelli	CV
WHITE CANVAS ACC. LIGHT	Lange	CCL
WHITE CANVAS ACC. TELA	Lange	CCL
WHITE CANVAS IN SEMPLICE	Lange	CCL
WHITE CHOCO ACC LIGHT	My Way	CE09
WHITE CHOCO ACC REPS	My Way	CE 11
WHITE CHOCO CRINKLE	My Way	CE 11
WHITE CHOCO CRINKLE LIGHT	My Way	CE 11
WHITE CHOCO IN SEMPLICE	My Way	CE 11
WHITE CROCO	Dalmatex	CCL
WHITE DENIM IN SEMPLICE	Italdenim	CCL
WHITE DENIM LIGHT	Italdenim	CCL
WHITE DENIM RESINATO	Italdenim	CCL
WHITE DENIM TELA	Italdenim	CCL
WHITE EAGLE ACC LIGHT	My Way	CE 10
WHITE EAGLE ACC TELA	My Way	CE 10
WHITE EAGLE IN SEMPLICE	My Way	CE 10
WHITE EGO	Dalmatex	CCL
WHITE FELT (VECCHIO)ACC.LIGHT	My Way	CV
WHITE FELT (VECCHIO)ACC.TELA	My Way	CV
WHITE FELT LIGHT	Lanificio di soci	CI 11/12
WHITE FELT SEMPLICE	Lanificio di soci	CI 11/12
WHITE FELT SOLO STAMPATO	Lanificio di soci	CSP
WHITE FELT TELA	Lanificio di soci	CI 11/12
WHITE FELT(VECCHIO) IN SEMPLICE	My Way	CV
WHITE FLOWER ACC LIGHT	Taborelli	CCL
WHITE FLOWER ACC TELA	Taborelli	CCL
WHITE FLOWER IN SEMPLICE	Taborelli	CCL
WHITE GROUND	Beccalli	CV
WHITE ICE	Lazzati	CI 11/12
WHITE JAY	Dalmatex	CCL
WHITE LADY solo in semplice	Taborelli	CE 10
WHITE LAME' ACC. LIGHT	Frigerio	CV
WHITE LAME' ACC. TELA	Frigerio	CV
WHITE LAME' IN SEMPLICE	Frigerio	CV
WHITE LAND +RESINA BEROFIN	My Way	CSP
WHITE LAND ACC LIGHT	My Way	CE 10
WHITE LAND ACC TELA	My Way	CE 10
WHITE LAND CRINKLE	My Way	CE 10
WHITE LAND CRINKLE ACC LIGHT	My Way	CE 10
WHITE LAND IN SEMPLICE	My Way	CE 10
WHITE LAND RESINA	My Way	CSP
WHITE LAND RESINATO MICHAEL KORS	My Way	CSP
WHITE LAND SEMPLICE  CESTO+ ENZIMI	My Way	CSP
WHITE LAND STOCK + RESINA	My Way	CSP
WHITE LEGEND ACC LIGHT	Pozzi	CE 10
WHITE LEGEND ACC TELA	Pozzi	CE 10
WHITE LEGEND IN SEMPLICE	Pozzi	CE 10
WHITE MESH apprettata	Pozzi	CE 12
WHITE MESH semplice	Pozzi	
WHITE MEXICAN IN SEMPLICE bicolore	Magitex	CCL
WHITE MEXICAN IN SEMPLICE monocolore	Magitex	CCL
WHITE MEXICAN LIGHT bicolore	Magitex	CCL
WHITE MEXICAN LIGHT monocolore	Magitex	CCL
WHITE MEXICAN TELA bicolore	Magitex	CCL
WHITE MEXICAN TELA monocolore	Magitex	CCL
WHITE OCEAN ACC LIGHT	Lange	CE 10
WHITE OCEAN ACC TELA	Lange	CE 10
WHITE OCEAN CRINKLE IN SEMPLICE	Lange	CE 10
WHITE OCEAN CRINKLE LIGHT	Lange	CE 10
WHITE OCEAN IN SEMPLICE	Lange	CE 10
WHITE PASSION	Taborelli	CI09/10
WHITE PEARL ACC  TELA	Taborelli	CCL
WHITE PEARL ACC LIGHT	Taborelli	CCL
WHITE PEARL IN SEMPLICE	Taborelli	CCL
WHITE PLANET LIGHT	Pozzi	CE 12
WHITE PLANET SEMPLICE	Pozzi	CE 12
WHITE PLANET TELA	Pozzi	CE 12
WHITE PLANET var 1 SECRET B.CO LIGHT	Pozzi	CE 12
WHITE PLANET var 1 SECRET B.CO SEMPLICE	Pozzi	CE 12
WHITE PLANET var 1 SECRET B.CO TELA	Pozzi	CE 12
WHITE PYTON ART 61 ACC LIGHT	Namsan Technology	CI 10/11
WHITE PYTON ART 61 IN SEMPLICE	Namsan Technology	CI 10/11
WHITE PYTON LIGHT	Dalmatex	CCL
WHITE PYTON TELA	Dalmatex	CCL
WHITE RAIN	Taborelli	CI09/10
WHITE REEF ACC TELA	Italdenim	CE 11
WHITE REEF IN SEMPLICE	Italdenim	CE 11
WHITE ROCK ACC. TELA	Radici Group	CCL
WHITE ROCK ACC.LIGHT	Radici Group	CCL
WHITE ROCK IN SEMPLICE	Radici Group	CCL
WHITE SAND	Lange	CV
WHITE SAND ACC. LIGHT	Lange	CCL
WHITE SAND ACC. TELA	Lange	CCL
WHITE SAND IN SEMPLICE	Lange	CCL
WHITE SENSATION ACC LIGHT	Taborelli	CE 10
WHITE SENSATION ACC TELA	Taborelli	CE 10
WHITE SENSATION IN SEMPLICE	Taborelli	CE 10
WHITE SHADE COLORATO CRINKLE	Lange	CE 10
WHITE SHADE COLORATO CRINKLE LIGHT	Lange	CE 10
WHITE SHADE TINTO ACC LIGHT	Lange	CE 10
WHITE SHADE TINTO ACC TELA	Lange	CE 10
WHITE SHADE TINTO IN SEMPLICE	Lange	CE 10
WHITE SHADE VAR 2 ACC LIGHT	Lange	CE 10
WHITE SHADE VAR 2 ACC TELA	Lange	CE 10
WHITE SHADE VAR 2 CRINKLE	Lange	CE 10
WHITE SHADE VAR 2 CRINKLE ACC LIGHT	Lange	CE 10
WHITE SHADE VAR 2 IN SEMPLICE	Lange	CE 10
WHITE SHARK	Pozzi	CE 10
WHITE SKIN ACC LIGHT	My Way	CE 11
WHITE SKIN ACC REPS	My Way	CE 11
WHITE SKIN CRINKLE	My Way	CE 11
WHITE SKIN CRINKLE LIGHT	My Way	CE 11
WHITE SKIN IN SEMPLICE	My Way	
WHITE SKY	Radici Group	CCL
WHITE SKY CON PLUME TINTO SEMPLICE	Radici Group	
WHITE SKY ROMBO	Radici Group	CSP
WHITE SOUL	Erco Pizzi	CV
WHITE SPIRIT	Taborelli	CI09/10
WHITE SPIRIT +  IDRO EUROFINISS	Taborelli	
WHITE SUNSET	Lange	CE 12
WHITE SWAMI ACC LIGHT	Taborelli	CI09/10
WHITE SWAMI ACC TELA	Taborelli	CI09/10
WHITE SWAMI IN SEMPLICE	Taborelli	CI09/10
WHITE TECH  IN SEMPLICE ARGENTO	Corti	CCL
WHITE TECH  IN SEMPLICE COLORATI	Corti	CCL
WHITE TECH  IN SEMPLICE ORO SATINATO	Corti	CCL
WHITE TECH  LIGHT ARGENTO	Corti	CCL
WHITE TECH  REPS ARGENTO	Corti	CCL
WHITE TECH  REPS COLORATI	Corti	CCL
WHITE TECH LIGHT COLORATI	Corti	CCL
WHITE TECH LIGHT ORO SATINATO	Corti	CCL
WHITE TECH REPS ORO SATINATO	Corti	CCL
WHITE VELVET  ACC. REPS	Namsan Technology	CV
WHITING	Ambiente Uomo	CV
WIBE	Redaelli	CV
WILD ACC. TELA	Griffine	CV
WILD BAY LIGHT	Pozzi	CE 12
WILD BAY SEMPLICE	Pozzi	CE 12
WILD BAY TELA	Pozzi	CE 12
WILD BAY VAR 1 SECRET B.CO LIGHT	Pozzi	CE 12
WILD BAY VAR 1 SECRET B.CO SEMPLICE	Pozzi	CE 12
WILD BAY VAR 1 SECRET B.CO TELA	Pozzi	CE 12
WILD CRINKLE ACC. LIGHT	Griffine	CV
WILD CRINKLE IN SEMPLICE	Griffine	CV
WILD LOFT	Griffine	CV
WILD METAL	Griffine	CSP
WILD SAND ACC LIGHT	Lange	CCL
WILD SAND ACC TELA	Lange	CCL
WILD SAND crinkle	Lange	CE 12
WILD SAND IN SEMPLICE	Lange	CCL
WILD SAND LIGHT	Lange	CE 12
WILD SAND SEMPLICE	Lange	CE 12
WILD SAND TELA	Lange	CE 12
WILD SEMPLICE	Griffine	CV
WILD SKY	Lange	CCL
WILD STONE LIGHT	Lange	CE 12
WILD STONE SEMPLICE	Lange	
WILD STONE TELA	Lange	CE 12
WILD VELVET  ACC. REPS	Redaelli	CCL
WILD VELVET IN SEMPLICE	Redaelli	CCL
WILLY	Forma	CV
WINCH ACC DENIM	Corti	CE 11
WINCH ACC LIGHT	Corti	CE 11
WINCH IN SEMPLICE	Corti	CE 11
WINCH REPS	Corti	CSP
WINCH RESINATO	Corti	CSP
WINCH VECCHIO VAR.1 - WASHED	Berto spa	CV
WINCH VECCHIO VAR.2	Berto spa	CV
WINGO ACC. LIGHT	Uco	CV
WINGO ACC. TELA	Uco	CV
WINGO IN SEMPLICE	Uco	CV
WINKY	Corti	CV
WOODY REPS	Corti	CV
WOODY RESINATO	Corti	CV
WOODY SEMPLICE	Corti	CV
WOODY SOFT	Corti	CV
WOOL JAZZ  ACC LIGHT	Taborelli	CI 10/11
WOOL JAZZ  ACC REPS	Taborelli	CI 10/11
WOOL JAZZ  IN SEMPLICE	Taborelli	CI 10/11
WOOL JAZZ CRINKLE ACC LIGHT	Taborelli	CI 10/11
WOOL JAZZ CRINKLE IN SEMPLICE	Taborelli	CI 10/11
WOOL STRETCH ACC LIGHT	Raion Inveruno	CI 11/12
WOOL STRETCH ACC REPS	Raion Inveruno	CI 11/12
WOOL STRETCH SEMPLICE	Raion Inveruno	CI 11/12
WRIGHT	Corti	CV
XAVIER ACC. LIGHT	Taborelli	CV
XAVIER ACC. REPS	Taborelli	CV
XAVIER IN SEMPLICE	Taborelli	CV
YADONG	Forma	CV
YADONG GREGGIO LIGHT	Forma	CV
YADONG GREGGIO TELA	Forma	CV
YANNICK	Mariani cinese	CV
YERA	Taborelli	CV
YONAS	Taborelli	CV
YORUBA BIANCO PRONTO TINTA	Lange	CV
YORUBA COLORATO	Lange	CV
YORUBA GREGGIO	Lange	CV
YOSHO REPS	Mariani cinese	CV
YOSHO SEMPLICE	Mariani cinese	CV
YOSHO SOFT	Mariani cinese	CV
YOSHO SPALMATO	Mariani cinese	CV
YOSHO STRETCH	Mariani cinese	CV
YUMI ACC. LIGHT	Pietro Mariani	CCL
YUMI ACC. MTP 2,5 + LIGHT	Pietro Mariani	CV
YUMI ACC. SOFT	Pietro Mariani	CCL
YUMI ACC. TELA	Pietro Mariani	CCL
YUMI IN SEMPLICE	Pietro Mariani	CCL
YUMI RESINATO	Pietro Mariani	CCL
ZAMBALIST  ACC LIGHT	Taborelli	CI 10/11
ZAMBALIST  ACC REPS	Taborelli	CI 10/11
ZAMBALIST  IN SEMPLICE	Taborelli	CI 10/11
ZAMBALIST GREGGIO LIGHT	Lange	CV
ZAMBALIST GREGGIO TELA	Lange	CV
ZAMBALIST LIGHT	Lange	CV
ZAMBALIST TELA	Lange	CV
ZANZA BASKET ALTRE VAR.	Valli	CV
ZANZA BASKET VAR 1	Valli	CV
ZANZARIERA COLORATA	Valli	CCL
ZANZARIERA GREGGIA	Valli	CCL
ZANZARIERA TINTA DA NOI	Valli	CCL
ZANZASILVER	Croma srl	CV
ZANZIBAR	Valli	CV
ZANZIBAR METAL LAMINA COLORATA	Erco Pizzi	CV
ZANZIBAR METAL LAMINA ORO/ARGENTO	Erco Pizzi	CV
ZAREK	Frigerio	CV
ZEBAH	Beccalli	CV
ZEBYR LIGHT	Mariani cinese	CV
ZEBYR REPS	Mariani cinese	CV
ZEBYR TELA	Mariani cinese	CV
ZED ACC. LYCRA	Heat Coat	CV
ZEKI ACC. REPS	Taborelli	CV
ZEKI IN SEMPLICE	Taborelli	CV
ZEKY ACC.LIGHT	Taborelli	CV
ZEN	Linea tess.italiana	CV
ZEN FLOWER ACC. LIGHT	Beccalli	CV
ZEN FLOWER ACC. REPS	Beccalli	CV
ZEN FLOWER IN SEMPLICE	Beccalli	CV
ZEN VELVET ACC. REPS	My Way	CV
ZEPHIR	Mariani cinese	CV
ZICKY METAL LIGHT	Dalmatex	CCL
ZICKY METAL SEMPLICE	Dalmatex	CCL
ZICKY METAL TELA	Dalmatex	CCL
ZIPPER	Lange	CV
ZIPPER ABB.	Corti	CV
ZONE SIX  ACC. REPS	My Way	CV
ZONE SIX ACC. LIGHT	My Way	CV
ZONE SIX IN SEMPLICE	My Way	CV
ZORAB	Taborelli	CV
ZUCCA FIOCCHETTINI FIL COUPE'	Frigerio	CSP
ZUCCA RASO FIL COUPE' SEMPLICE	Frigerio	CSP
ZUCCA RASO FIL COUPE'RESINATO	Frigerio	CSP
ZUCCA TARTAN FIL COUPE'	Frigerio	